Rk,Player,School,Conf,G,Rec,Yds,Avg,TD,Att,Yds,Avg,TD,Plays,Yds,Avg,TD,-9999
1,Devin Smith,Ohio State,Big Ten,14,33,931,28.2,12,0,0,,0,33,931,28.2,12,devin-smith-2
2,Phillip Dorsett,Miami (FL),ACC,12,36,871,24.2,10,2,-6,-3,0,38,865,22.8,10,phillip-dorsett-1
3,Chris Moore,Cincinnati,American,11,30,673,22.4,8,0,0,,0,30,673,22.4,8,chris-moore-4
4,Sammie Coates,Auburn,SEC,12,34,741,21.8,4,0,0,,0,34,741,21.8,4,sammie-coates-1
5,Ian Hamilton,UTEP,CUSA,12,27,579,21.4,2,0,0,,0,27,579,21.4,2,ian-hamilton-1
6,Breshad Perriman,UCF,American,13,50,1044,20.9,9,1,0,0,0,51,1044,20.5,9,breshad-perriman-1
7,Travin Dural,LSU,SEC,13,37,758,20.5,7,10,111,11.1,0,47,869,18.5,7,travin-dural-1
8,Deandre Smelter,Georgia Tech,ACC,10,35,715,20.4,7,3,103,34.3,1,38,818,21.5,8,deandre-smelter-1
9,Glenn Coleman,Florida International,CUSA,11,23,468,20.3,3,2,4,2,0,25,472,18.9,3,glenn-coleman-1
10,Devante Parker,Louisville,ACC,6,43,855,19.9,5,0,0,,0,43,855,19.9,5,devante-parker-1
11,Leonte Carroo,Rutgers,Big Ten,13,55,1086,19.7,10,0,0,,0,55,1086,19.7,10,leonte-carroo-1
12,Carlos Henderson,Louisiana Tech,CUSA,12,29,569,19.6,4,13,72,5.5,0,42,641,15.3,4,carlos-henderson-1
13,Rokeem Williams,Miami (OH),MAC,10,35,682,19.5,3,5,4,0.8,0,40,686,17.2,3,rokeem-williams-1
14,Mario Hull,Rice,CUSA,11,32,621,19.4,8,0,0,,0,32,621,19.4,8,mario-hull-1
15,Thomas Duarte,UCLA,Pac-12,10,28,540,19.3,4,0,0,,0,28,540,19.3,4,thomas-duarte-1
16,Darius Jennings,Virginia,ACC,12,27,521,19.3,2,24,115,4.8,1,51,636,12.5,3,darius-jennings-1
17,Sterling Shepard,Oklahoma,Big 12,11,51,970,19,5,8,41,5.1,0,59,1011,17.1,5,sterling-shepard-1
18,Darren Carrington,Oregon,Pac-12,10,37,704,19,4,0,0,,0,37,704,19,4,darren-carrington-1
19,Devin Lauderdale,Texas Tech,Big 12,10,31,589,19,7,0,0,,0,31,589,19,7,devin-lauderdale-1
20,Keith Mumphery,Michigan State,Big Ten,12,26,495,19,3,6,85,14.2,1,32,580,18.1,4,keith-mumphery-1
21,Brandon Sheperd,Oklahoma State,Big 12,13,39,737,18.9,5,4,69,17.3,0,43,806,18.7,5,brandon-sheperd-1
22,Jalen Robinette,Air Force,MWC,13,43,806,18.7,4,0,0,,0,43,806,18.7,4,jalen-robinette-1
23,J.J. Nelson,UAB,CUSA,12,35,655,18.7,4,5,45,9,0,40,700,17.5,4,jamarcus-nelson-1
24,Cam Worthy,East Carolina,American,11,55,1016,18.5,4,0,0,,0,55,1016,18.5,4,cam-worthy-1
25,Tony Lippett,Michigan State,Big Ten,13,65,1198,18.4,11,2,51,25.5,1,67,1249,18.6,12,tony-lippett-1
26,Kolby Listenbee,TCU,Big 12,13,41,753,18.4,4,2,19,9.5,0,43,772,18,4,kolby-listenbee-1
27,Chris Conley,Georgia,SEC,13,36,657,18.3,8,0,0,,0,36,657,18.3,8,chris-conley-1
28,Rashard Higgins,Colorado State,MWC,12,96,1750,18.2,17,0,0,,0,96,1750,18.2,17,rashard-higgins-1
29,Corey Davis,Western Michigan,MAC,12,78,1408,18.1,15,0,0,,0,78,1408,18.1,15,corey-davis-3
30,Mike Williams,Clemson,ACC,12,57,1030,18.1,6,0,0,,0,57,1030,18.1,6,mike-williams-17
31,Javess Blue,Kentucky,SEC,11,29,525,18.1,5,0,0,,0,29,525,18.1,5,javess-blue-1
32,Nigel King,Kansas,Big 12,11,30,537,17.9,1,0,0,,0,30,537,17.9,1,nigel-king-1
33,K.D. Cannon,Baylor,Big 12,13,58,1030,17.8,8,2,12,6,0,60,1042,17.4,8,kd-cannon-1
34,Vince Sanders,Ole Miss,SEC,11,39,696,17.8,6,0,0,,0,39,696,17.8,6,vince-sanders-1
35,C.J. Prosise,Notre Dame,Ind,13,29,516,17.8,2,10,126,12.6,1,39,642,16.5,3,cj-prosise-1
36,Devante Davis,UNLV,MWC,8,34,599,17.6,4,0,0,,0,34,599,17.6,4,devante-davis-1
37,Corey Coleman,Baylor,Big 12,10,64,1119,17.5,11,11,53,4.8,1,75,1172,15.6,12,corey-coleman-1
38,Jimmie Hunt,Missouri,SEC,12,40,698,17.5,7,0,0,,0,40,698,17.5,7,jimmie-hunt-1
39,Mack Hollins,North Carolina,ACC,13,35,613,17.5,8,0,0,,0,35,613,17.5,8,mack-hollins-1
40,Charles Lovett,Colorado State,MWC,13,28,490,17.5,3,2,15,7.5,0,30,505,16.8,3,charles-lovett-1
41,Evan Engram,Ole Miss,SEC,10,38,662,17.4,2,0,0,,0,38,662,17.4,2,evan-engram-1
42,Dijon Paschal,Arkansas State,Sun Belt,12,37,642,17.4,4,0,0,,0,37,642,17.4,4,dijon-paschal-1
43,Thomas Sperbeck,Boise State,MWC,11,51,877,17.2,3,2,11,5.5,0,53,888,16.8,3,thomas-sperbeck-1
44,Taywan Taylor,Western Kentucky,CUSA,12,45,767,17,7,1,11,11,0,46,778,16.9,7,taywan-taylor-1
45,Jordan Westerkamp,Nebraska,Big Ten,13,44,747,17,5,0,0,,0,44,747,17,5,jordan-westerkamp-1
46,Kenny Bell,Nebraska,Big Ten,13,47,788,16.8,6,0,0,,0,47,788,16.8,6,kenny-bell-2
47,Markeith Ambles,Houston,American,13,32,539,16.8,4,0,0,,0,32,539,16.8,4,markeith-ambles-2
48,Devon Allen,Oregon,Pac-12,14,41,684,16.7,7,1,21,21,0,42,705,16.8,7,devon-allen-1
49,Trevor Davis,California,Pac-12,9,24,399,16.6,5,0,0,,0,24,399,16.6,5,trevor-davis-1
50,Pharoh Cooper,South Carolina,SEC,13,69,1136,16.5,9,27,200,7.4,2,96,1336,13.9,11,pharoh-cooper-1
51,Mekale McKay,Cincinnati,American,13,44,725,16.5,8,0,0,,0,44,725,16.5,8,mekale-mckay-3
52,Andre Davis,South Florida,American,8,36,594,16.5,7,0,0,,0,36,594,16.5,7,andre-davis-4
53,Jordan Villamin,Oregon State,Pac-12,10,35,578,16.5,6,0,0,,0,35,578,16.5,6,jordan-villamin-1
54,Der'Rikk Thompson,SMU,American,9,31,512,16.5,1,2,0,0,0,33,512,15.5,1,derrikk-thompson-1
55,Matt Miller,Boise State,MWC,5,28,461,16.5,3,0,0,,0,28,461,16.5,3,matt-miller-6
56,Devon Cajuste,Stanford,Pac-12,10,34,557,16.4,6,0,0,,0,34,557,16.4,6,devon-cajuste-1
57,Titus Davis,Central Michigan,MAC,10,60,980,16.3,13,3,20,6.7,0,63,1000,15.9,13,titus-davis-1
58,Malachi Jones,Appalachian State,Sun Belt,12,36,585,16.3,3,0,0,,0,36,585,16.3,3,malachi-jones-1
59,Fred Ross,Mississippi State,SEC,11,30,489,16.3,5,2,6,3,0,32,495,15.5,5,fred-ross-1
60,Rodney Mills,Massachusetts,MAC,12,30,489,16.3,5,0,0,,0,30,489,16.3,5,rodney-mills-1
61,James Washington,Oklahoma State,Big 12,12,28,456,16.3,6,1,20,20,0,29,476,16.4,6,james-washington-5
62,Tyler Boyd,Pitt,ACC,13,78,1261,16.2,8,12,63,5.3,0,90,1324,14.7,8,tyler-boyd-1
63,Antonio Vaughan,Old Dominion,CUSA,12,63,1019,16.2,12,6,31,5.2,0,69,1050,15.2,12,antonio-vaughan-1
64,Josh Reynolds,Texas A&M,SEC,13,52,842,16.2,13,0,0,,0,52,842,16.2,13,josh-reynolds-1
65,D'Haquille Williams,Auburn,SEC,10,45,730,16.2,5,0,0,,0,45,730,16.2,5,dhaquille-williams-1
66,Danny Anthrop,Purdue,Big Ten,9,38,616,16.2,4,3,10,3.3,0,41,626,15.3,4,danny-anthrop-1
67,Deante' Gray,TCU,Big 12,11,36,582,16.2,8,8,88,11,0,44,670,15.2,8,deante-gray-1
68,Jesse Kroll,Central Michigan,MAC,11,36,582,16.2,4,3,16,5.3,0,39,598,15.3,4,jesse-kroll-1
69,Ezell Ruffin,San Diego State,MWC,7,26,422,16.2,2,2,-2,-1,0,28,420,15,2,ezell-ruffin-1
70,David Frazier,Miami (OH),MAC,11,59,949,16.1,5,1,5,5,0,60,954,15.9,5,david-frazier-2
71,Samajie Grant,Arizona,Pac-12,13,45,718,16,6,2,9,4.5,0,47,727,15.5,6,samajie-grant-1
72,Maxx Williams,Minnesota,Big Ten,12,36,569,15.8,8,0,0,,0,36,569,15.8,8,maxx-williams-1
73,C.J. Duncan,Vanderbilt,SEC,11,28,441,15.8,4,2,4,2,0,30,445,14.8,4,cj-duncan-1
74,Da'Ron Brown,Northern Illinois,MAC,14,68,1065,15.7,6,10,108,10.8,1,78,1173,15,7,daron-brown-1
75,Josh Doctson,TCU,Big 12,13,65,1018,15.7,11,0,0,,0,65,1018,15.7,11,josh-doctson-1
76,James Quick,Louisville,ACC,12,36,566,15.7,3,2,9,4.5,0,38,575,15.1,3,james-quick-1
77,Jordan Taylor,Rice,CUSA,10,54,842,15.6,7,0,0,,0,54,842,15.6,7,jordan-taylor-2
78,John Harris,Texas,Big 12,13,68,1051,15.5,7,0,0,,0,68,1051,15.5,7,john-harris-1
79,Jean Sifrin,Massachusetts,MAC,11,41,637,15.5,6,0,0,,0,41,637,15.5,6,jean-sifrin-1
80,Miles Gooch,Virginia,ACC,7,24,371,15.5,1,0,0,,0,24,371,15.5,1,miles-gooch-1
81,Ron Willoughby,Buffalo,MAC,11,50,771,15.4,9,0,0,,0,50,771,15.4,9,ron-willoughby-1
82,Clive Walford,Miami (FL),ACC,11,44,676,15.4,7,0,0,,0,44,676,15.4,7,clive-walford-1
83,Jay Lee,Baylor,Big 12,10,41,633,15.4,6,0,0,,0,41,633,15.4,6,jay-lee-1
84,Joe Hansley,Colorado State,MWC,11,35,540,15.4,2,7,13,1.9,0,42,553,13.2,2,joe-hansley-1
85,Steve Ishmael,Syracuse,ACC,10,27,415,15.4,3,0,0,,0,27,415,15.4,3,steve-ishmael-1
86,Montez McGuire,Appalachian State,Sun Belt,11,25,386,15.4,2,0,0,,0,25,386,15.4,2,montez-mcguire-1
87,Joshua McCain,Idaho,Sun Belt,11,76,1162,15.3,9,1,3,3,0,77,1165,15.1,9,joshua-mccain-1
88,Demarcus Robinson,Florida,SEC,11,53,810,15.3,7,1,3,3,0,54,813,15.1,7,demarcus-robinson-3
89,Dom Williams,Washington State,Pac-12,11,43,656,15.3,9,0,0,,0,43,656,15.3,9,dom-williams-1
90,Mitchell Henry,Western Kentucky,CUSA,11,32,489,15.3,4,0,0,,0,32,489,15.3,4,mitchell-henry-1
91,Demarco Robinson,Kentucky,SEC,12,33,501,15.2,1,1,0,0,0,34,501,14.7,1,demarco-robinson-1
92,Tajae Sharpe,Massachusetts,MAC,12,85,1281,15.1,7,3,14,4.7,0,88,1295,14.7,7,tajae-sharpe-1
93,Devonte Boyd,UNLV,MWC,13,65,980,15.1,4,1,5,5,0,66,985,14.9,4,devonte-boyd-1
94,Ajalen Holley,Louisiana-Monroe,Sun Belt,12,57,863,15.1,7,1,9,9,0,58,872,15,7,ajalen-holley-1
95,Alonzo Russell,Toledo,MAC,13,51,770,15.1,8,0,0,,0,51,770,15.1,8,alonzo-russell-1
96,Edward Pope,Texas A&M,SEC,12,30,454,15.1,4,0,0,,0,30,454,15.1,4,edward-pope-1
97,Mitchell Juergens,Brigham Young,Ind,12,28,424,15.1,4,6,23,3.8,0,34,447,13.1,4,mitchell-juergens-1
98,Roger Lewis,Bowling Green State,MAC,14,73,1094,15,7,1,-3,-3,0,74,1091,14.7,7,roger-lewis-1
99,Darius Phillips,Western Michigan,MAC,12,32,479,15,2,3,37,12.3,0,35,516,14.7,2,darius-phillips-1
100,Keyarris Garrett,Tulsa,American,10,47,698,14.9,5,0,0,,0,47,698,14.9,5,keyarris-garrett-1
101,Dwayne Stanford,Oregon,Pac-12,13,43,639,14.9,6,0,0,,0,43,639,14.9,6,dwayne-stanford-1
102,Garrett Brown,Air Force,MWC,12,36,535,14.9,6,36,195,5.4,1,72,730,10.1,7,garrett-brown-2
103,Johnny Holton,Cincinnati,American,13,29,431,14.9,5,0,0,,0,29,431,14.9,5,johnny-holton-1
104,Donovan Harden,Georgia State,Sun Belt,12,60,885,14.8,7,2,15,7.5,0,62,900,14.5,7,donovan-harden-2
105,Michael Thomas,Ohio State,Big Ten,15,54,799,14.8,9,0,0,,0,54,799,14.8,9,michael-thomas-3
106,Eldridge Massington,UCLA,Pac-12,11,25,367,14.7,3,0,0,,0,25,367,14.7,3,eldridge-massington-1
107,Robert Davis,Georgia State,Sun Belt,12,50,732,14.6,2,1,3,3,0,51,735,14.4,2,robert-davis-10
108,Geronimo Allison,Illinois,Big Ten,11,41,598,14.6,5,0,0,,0,41,598,14.6,5,geronimo-allison-1
109,Travis Rudolph,Florida State,ACC,10,38,555,14.6,4,0,0,,0,38,555,14.6,4,travis-rudolph-1
110,Ian Sadler,Texas Tech,Big 12,7,23,336,14.6,2,0,0,,0,23,336,14.6,2,ian-sadler-1
111,Mario Alford,West Virginia,Big 12,13,65,945,14.5,11,2,14,7,0,67,959,14.3,11,mario-alford-1
112,De'Runnya Wilson,Mississippi State,SEC,10,47,680,14.5,9,0,0,,0,47,680,14.5,9,derunnya-wilson-1
113,Cameron Smith,Arizona State,Pac-12,11,41,596,14.5,6,3,25,8.3,0,44,621,14.1,6,cameron-smith-2
114,William Fuller,Notre Dame,Ind,13,76,1094,14.4,15,0,0,,0,76,1094,14.4,15,william-fuller-2
115,Stephen Anderson,California,Pac-12,10,46,661,14.4,5,0,0,,0,46,661,14.4,5,stephen-anderson-2
116,Michael Thomas,Southern Mississippi,CUSA,12,41,592,14.4,5,0,0,,0,41,592,14.4,5,michael-thomas-6
117,Juwan Brescacin,Northern Illinois,MAC,11,31,445,14.4,6,0,0,,0,31,445,14.4,6,juwan-brescacin-1
118,Josiah Price,Michigan State,Big Ten,10,26,374,14.4,6,0,0,,0,26,374,14.4,6,josiah-price-1
119,Tyler Lockett,Kansas State,Big 12,13,106,1515,14.3,11,3,17,5.7,0,109,1532,14.1,11,tyler-lockett-1
120,Jarrod West,Syracuse,ACC,10,49,700,14.3,0,0,0,,0,49,700,14.3,0,jarrod-west-1
121,Jared Murphy,Miami (OH),MAC,12,42,600,14.3,4,10,28,2.8,2,52,628,12.1,6,jared-murphy-1
122,J.J. Worton,UCF,American,10,36,514,14.3,5,0,0,,0,36,514,14.3,5,jj-worton-1
123,Xavier Williams,Colorado State,MWC,13,30,430,14.3,3,0,0,,0,30,430,14.3,3,xavier-williams-1
124,Devin Clarke,Middle Tennessee State,CUSA,10,25,358,14.3,2,0,0,,0,25,358,14.3,2,devin-clarke-1
125,Jaelen Strong,Arizona State,Pac-12,12,82,1165,14.2,10,0,0,,0,82,1165,14.2,10,jaelen-strong-1
126,Jordan Payton,UCLA,Pac-12,13,67,954,14.2,7,0,0,,0,67,954,14.2,7,jordan-payton-1
127,Hunter Sharp,Utah State,MWC,13,66,939,14.2,7,6,28,4.7,0,72,967,13.4,7,hunter-sharp-1
128,Marcus Kemp,Hawaii,MWC,12,56,797,14.2,3,0,0,,0,56,797,14.2,3,marcus-kemp-1
129,Jordan Leslie,Brigham Young,Ind,13,55,779,14.2,6,3,34,11.3,1,58,813,14,7,jordan-leslie-1
130,David Glidden,Oklahoma State,Big 12,12,42,598,14.2,2,0,0,,0,42,598,14.2,2,david-glidden-1
131,Joshua Reese,UCF,American,12,39,552,14.2,6,4,16,4,0,43,568,13.2,6,joshua-reese-1
132,Chris Brown,Notre Dame,Ind,13,39,548,14.1,1,1,5,5,0,40,553,13.8,1,chris-brown-11
133,Deon Butler,Central Michigan,MAC,11,30,424,14.1,1,0,0,,0,30,424,14.1,1,deon-butler-2
134,Sterling Griffin,Louisiana Tech,CUSA,9,29,408,14.1,2,0,0,,0,29,408,14.1,2,sterling-griffin-3
135,Vince Mayle,Washington State,Pac-12,12,106,1483,14,9,0,0,,0,106,1483,14,9,vince-mayle-1
136,Cayleb Jones,Arizona,Pac-12,14,73,1019,14,9,0,0,,0,73,1019,14,9,cayleb-jones-2
137,Jakeem Grant,Texas Tech,Big 12,12,67,938,14,7,5,35,7,0,72,973,13.5,7,jakeem-grant-1
138,Alex Erickson,Wisconsin,Big Ten,13,55,772,14,3,3,1,0.3,0,58,773,13.3,3,alex-erickson-1
139,Jalen Claiborne,Wyoming,MWC,12,41,576,14,3,2,1,0.5,0,43,577,13.4,3,jalen-claiborne-1
140,Tyler McCulloch,Colorado,Pac-12,9,30,419,14,2,0,0,,0,30,419,14,2,tyler-mcculloch-1
141,Shane Tucker,Middle Tennessee State,CUSA,12,25,351,14,4,97,486,5,8,122,837,6.9,12,shane-tucker-1
142,Rodney Adams,South Florida,American,9,23,323,14,2,5,52,10.4,1,28,375,13.4,3,rodney-adams-1
143,Demornay Pierson-El,Nebraska,Big Ten,13,23,321,14,4,5,10,2,0,28,331,11.8,4,demornay-pierson-el-1
144,Amari Cooper,Alabama,SEC,14,124,1727,13.9,16,5,23,4.6,0,129,1750,13.6,16,amari-cooper-1
145,Shavarez Smith,South Alabama,Sun Belt,13,54,748,13.9,8,1,-13,-13,0,55,735,13.4,8,shavarez-smith-1
146,Tevaun Smith,Iowa,Big Ten,13,43,596,13.9,3,3,43,14.3,0,46,639,13.9,3,tevaun-smith-1
147,Hunter Henry,Arkansas,SEC,12,37,513,13.9,2,0,0,,0,37,513,13.9,2,hunter-henry-1
148,Marquise Ricard,Southern Mississippi,CUSA,12,30,417,13.9,2,0,0,,0,30,417,13.9,2,marquise-ricard-1
149,Macgarrett Kings Jr.,Michigan State,Big Ten,13,29,404,13.9,1,12,71,5.9,0,41,475,11.6,1,macgarrett-kings-jr-1
150,Rashad Greene,Florida State,ACC,14,99,1365,13.8,7,1,-2,-2,0,100,1363,13.6,7,rashad-greene-1
151,Antwan Goodley,Baylor,Big 12,10,60,830,13.8,6,8,71,8.9,0,68,901,13.3,6,antwan-goodley-1
152,Jalen Fitzpatrick,Temple,American,12,53,730,13.8,6,2,-10,-5,0,55,720,13.1,6,jalen-fitzpatrick-1
153,D'Vario Montgomery,Iowa State,Big 12,9,44,605,13.8,2,1,9,9,0,45,614,13.6,2,dvario-montgomery-1
154,Canaan Severin,Virginia,ACC,12,42,578,13.8,5,0,0,,0,42,578,13.8,5,canaan-severin-1
155,Mike Dudek,Illinois,Big Ten,13,76,1038,13.7,6,6,73,12.2,0,82,1111,13.5,6,mike-dudek-1
156,Geno Lewis,Penn State,Big Ten,13,55,751,13.7,2,1,1,1,0,56,752,13.4,2,geno-lewis-1
157,Bo Hines,North Carolina State,ACC,12,45,616,13.7,1,1,3,3,0,46,619,13.5,1,bo-hines-1
158,Jenson Stoshak,Florida Atlantic,CUSA,12,37,508,13.7,2,0,0,,0,37,508,13.7,2,jenson-stoshak-1
159,Shaq Roland,South Carolina,SEC,9,26,356,13.7,4,0,0,,0,26,356,13.7,4,shaq-roland-1
160,Byron Marshall,Oregon,Pac-12,15,74,1003,13.6,6,52,392,7.5,1,126,1395,11.1,7,byron-marshall-1
161,Cody Core,Ole Miss,SEC,13,41,558,13.6,6,4,86,21.5,0,45,644,14.3,6,cody-core-1
162,Tanner Gentry,Wyoming,MWC,12,32,435,13.6,2,2,3,1.5,0,34,438,12.9,2,tanner-gentry-1
163,Malcolm Johnson,Mississippi State,SEC,12,28,380,13.6,3,0,0,,0,28,380,13.6,3,malcolm-johnson-2
164,Jordan Reid,Ohio,MAC,10,24,326,13.6,1,0,0,,0,24,326,13.6,1,jordan-reid-1
165,B.J. Johnson,Georgia Southern,Sun Belt,11,23,312,13.6,3,3,29,9.7,0,26,341,13.1,3,bj-johnson-2
166,Corey Robinson,Notre Dame,Ind,12,40,539,13.5,5,0,0,,0,40,539,13.5,5,corey-robinson-3
167,Steven Scheu,Vanderbilt,SEC,12,39,525,13.5,4,0,0,,0,39,525,13.5,4,steven-scheu-1
168,Bryan Holmes,Troy,Sun Belt,11,34,460,13.5,5,1,4,4,0,35,464,13.3,5,bryan-holmes-1
169,Curry Sexton,Kansas State,Big 12,13,79,1059,13.4,5,0,0,,0,79,1059,13.4,5,curry-sexton-1
170,Jordan Williams,Ball State,MAC,11,56,753,13.4,6,0,0,,0,56,753,13.4,6,jordan-williams-3
171,JuJu Smith-Schuster,USC,Pac-12,13,54,724,13.4,5,2,3,1.5,0,56,727,13,5,juju-smith-1
172,Tyreese Russell,Eastern Michigan,MAC,12,39,523,13.4,3,1,7,7,0,40,530,13.3,3,tyreese-russell-1
173,Scott Harding,Hawaii,MWC,13,34,457,13.4,3,0,0,,0,34,457,13.4,3,scott-harding-1
174,Tevin Jones,Memphis,American,12,33,442,13.4,3,1,0,0,0,34,442,13,3,tevin-jones-1
175,Dennis Parks,Rice,CUSA,9,29,389,13.4,1,0,0,,0,29,389,13.4,1,dennis-parks-1
176,Amir Carlisle,Notre Dame,Ind,12,23,309,13.4,3,7,46,6.6,0,30,355,11.8,3,amir-carlisle-2
177,Kevin White,West Virginia,Big 12,13,109,1447,13.3,10,0,0,,0,109,1447,13.3,10,kevin-white-6
178,Ronald Butler,Utah State,MWC,14,36,478,13.3,2,6,72,12,0,42,550,13.1,2,ronald-butler-1
179,Sam Arneson,Wisconsin,Big Ten,14,29,387,13.3,4,0,0,,0,29,387,13.3,4,sam-arneson-1
180,Alan Cross,Memphis,American,12,28,373,13.3,4,1,1,1,1,29,374,12.9,5,alan-cross-2
181,David Grinnage,North Carolina State,ACC,11,27,358,13.3,5,0,0,,0,27,358,13.3,5,david-grinnage-1
182,Joel German,Western Kentucky,CUSA,13,27,358,13.3,4,0,0,,0,27,358,13.3,4,joel-german-1
183,Cameron Dickerson,Northwestern,Big Ten,9,24,318,13.3,1,0,0,,0,24,318,13.3,1,cameron-dickerson-1
184,Laquon Treadwell,Ole Miss,SEC,9,48,632,13.2,5,2,-7,-3.5,0,50,625,12.5,5,laquon-treadwell-1
185,Dominic Rufran,Wyoming,MWC,12,45,596,13.2,0,6,15,2.5,0,51,611,12,0,dominic-rufran-1
186,Allen Lazard,Iowa State,Big 12,12,45,593,13.2,3,0,0,,0,45,593,13.2,3,allen-lazard-1
187,Markese Triplett,Southern Mississippi,CUSA,12,40,529,13.2,1,0,0,,0,40,529,13.2,1,markese-triplett-1
188,Marcus Henry,Middle Tennessee State,CUSA,11,40,527,13.2,4,0,0,,0,40,527,13.2,4,marcus-henry-2
189,Josh Robinson,Mississippi State,SEC,13,28,370,13.2,1,190,1203,6.3,11,218,1573,7.2,12,josh-robinson-2
190,Jalin Marshall,Ohio State,Big Ten,15,38,499,13.1,6,25,145,5.8,1,63,644,10.2,7,jalin-marshall-1
191,Amara Darboh,Michigan,Big Ten,11,36,473,13.1,2,0,0,,0,36,473,13.1,2,amara-darboh-1
192,Gehrig Dieter,Bowling Green State,MAC,8,35,460,13.1,1,0,0,,0,35,460,13.1,1,gehrig-dieter-1
193,Aaron Peck,Fresno State,MWC,12,32,419,13.1,3,0,0,,0,32,419,13.1,3,aaron-peck-1
194,Trey Griffey,Arizona,Pac-12,13,31,405,13.1,1,0,0,,0,31,405,13.1,1,trey-griffey-1
195,Bra'Lon Cherry,North Carolina State,ACC,11,27,354,13.1,3,6,40,6.7,2,33,394,11.9,5,bralon-cherry-1
196,Bud Sasser,Missouri,SEC,14,77,1003,13,12,0,0,,0,77,1003,13,12,bud-sasser-1
197,Trent Taylor,Louisiana Tech,CUSA,14,64,834,13,9,0,0,,0,64,834,13,9,trent-taylor-2
198,Kenny Lawler,California,Pac-12,11,54,701,13,9,0,0,,0,54,701,13,9,kenny-lawler-1
199,Austin Hill,Arizona,Pac-12,14,49,635,13,4,0,0,,0,49,635,13,4,austin-hill-1
200,Jimmay Mundine,Kansas,Big 12,11,45,584,13,3,0,0,,0,45,584,13,3,jimmay-mundine-1
201,Keon Hatcher,Arkansas,SEC,13,43,558,13,6,5,112,22.4,1,48,670,14,7,keon-hatcher-1
202,Jerrel Brown,New Mexico State,Sun Belt,10,34,442,13,2,0,0,,0,34,442,13,2,jerrel-brown-1
203,Westlee Tonga,Utah,Pac-12,11,30,391,13,4,0,0,,0,30,391,13,4,westlee-tonga-1
204,Chris Godwin,Penn State,Big Ten,13,26,338,13,2,2,1,0.5,0,28,339,12.1,2,chris-godwin-1
205,Alex Welch,Miami (OH),MAC,8,24,312,13,2,0,0,,0,24,312,13,2,alex-welch-1
206,Tres Houston,Arkansas State,Sun Belt,13,53,685,12.9,4,0,0,,0,53,685,12.9,4,tres-houston-1
207,Nick O'Leary,Florida State,ACC,13,48,618,12.9,6,0,0,,1,48,618,12.9,7,nick-oleary-1
208,Hasaan Henderson,Nevada,MWC,9,45,579,12.9,4,0,0,,0,45,579,12.9,4,hasaan-henderson-1
209,Justyn Shackleford,Tulane,American,11,36,465,12.9,2,0,0,,0,36,465,12.9,2,justyn-shackleford-1
210,Marken Michel,Massachusetts,MAC,12,30,386,12.9,1,19,115,6.1,2,49,501,10.2,3,marken-michel-1
211,Stefon Diggs,Maryland,Big Ten,10,62,792,12.8,5,5,28,5.6,0,67,820,12.2,5,stefon-diggs-1
212,Kenneth Dixon,Louisiana Tech,CUSA,14,30,385,12.8,6,253,1299,5.1,22,283,1684,6,28,kenneth-dixon-1
213,Deshon Foxx,Connecticut,American,12,30,384,12.8,1,23,203,8.8,1,53,587,11.1,2,deshon-foxx-1
214,Josh Bordner,Boston College,ACC,13,27,346,12.8,3,0,0,,0,27,346,12.8,3,josh-bordner-1
215,Alex Deleon,Florida Atlantic,CUSA,10,23,295,12.8,5,0,0,,0,23,295,12.8,5,alex-deleon-1
216,Artavis Scott,Clemson,ACC,12,76,965,12.7,8,6,18,3,0,82,983,12,8,artavis-scott-1
217,Isaiah Ford,Virginia Tech,ACC,13,56,709,12.7,6,4,0,0,0,60,709,11.8,6,isaiah-ford-1
218,David Washington,Old Dominion,CUSA,12,47,599,12.7,4,1,0,0,0,48,599,12.5,4,david-washington-4
219,Speedy Noil,Texas A&M,SEC,12,46,583,12.7,5,1,10,10,0,47,593,12.6,5,speedy-noil-1
220,Danny Woodson Jr.,South Alabama,Sun Belt,12,30,382,12.7,4,0,0,,0,30,382,12.7,4,danny-woodson-jr-1
221,Nelson Agholor,USC,Pac-12,13,104,1313,12.6,12,4,3,0.8,0,108,1316,12.2,12,nelson-agholor-1
222,Mitch Mathews,Brigham Young,Ind,13,73,922,12.6,9,0,0,,0,73,922,12.6,9,mitch-mathews-1
223,Bradley Marquez,Texas Tech,Big 12,12,65,821,12.6,10,0,0,,0,65,821,12.6,10,bradley-marquez-1
224,Zach Pascal,Old Dominion,CUSA,12,59,743,12.6,7,0,0,,0,59,743,12.6,7,zach-pascal-1
225,Shane Wynn,Indiana,Big Ten,12,56,708,12.6,3,4,138,34.5,2,60,846,14.1,5,shane-wynn-1
226,Deandrew White,Alabama,SEC,10,40,504,12.6,4,2,-4,-2,0,42,500,11.9,4,deandrew-white-1
227,George Farmer,USC,Pac-12,10,25,314,12.6,4,2,2,1,0,27,316,11.7,4,george-farmer-2
228,Isiah Myers,Washington State,Pac-12,12,78,972,12.5,12,0,0,,0,78,972,12.5,12,isiah-myers-1
229,Chris Humphrey,Kent State,MAC,11,51,635,12.5,5,0,0,,0,51,635,12.5,5,chris-humphrey-1
230,Jesus Wilson,Florida State,ACC,13,42,527,12.5,4,0,0,,0,42,527,12.5,4,jesus-wilson-1
231,Austin Hooper,Stanford,Pac-12,12,40,499,12.5,2,0,0,,0,40,499,12.5,2,austin-hooper-1
232,Cam Phillips,Virginia Tech,ACC,10,40,498,12.5,3,5,65,13,0,45,563,12.5,3,cam-phillips-1
233,Janarion Grant,Rutgers,Big Ten,11,25,312,12.5,0,5,52,10.4,0,30,364,12.1,0,janarion-grant-1
234,Tommy Shuler,Marshall,CUSA,14,92,1138,12.4,9,0,0,,0,92,1138,12.4,9,tommy-shuler-1
235,Corey Jones,Toledo,MAC,13,68,842,12.4,5,8,88,11,0,76,930,12.2,5,corey-jones-3
236,Ryan Switzer,North Carolina,ACC,13,61,757,12.4,4,8,29,3.6,0,69,786,11.4,4,ryan-switzer-1
237,Antwane Grant,Western Kentucky,CUSA,10,41,509,12.4,6,0,0,,0,41,509,12.4,6,antwane-grant-1
238,James Butler,Louisiana,Sun Belt,11,38,470,12.4,0,0,0,,0,38,470,12.4,0,james-butler-2
239,Sebastian Smith,Ohio,MAC,10,31,385,12.4,2,0,0,,0,31,385,12.4,2,sebastian-smith-1
240,Darius White,Missouri,SEC,10,30,372,12.4,4,0,0,,0,30,372,12.4,4,darius-white-1
241,Justin Hardy,East Carolina,American,13,121,1494,12.3,10,1,7,7,1,122,1501,12.3,11,justin-hardy-1
242,Jamison Crowder,Duke,ACC,13,85,1044,12.3,6,2,9,4.5,0,87,1053,12.1,6,jamison-crowder-1
243,Carlos Harris,North Texas,CUSA,12,70,863,12.3,3,9,92,10.2,1,79,955,12.1,4,carlos-harris-1
244,Ronnie Moore,Bowling Green State,MAC,14,56,690,12.3,5,21,129,6.1,2,77,819,10.6,7,ronnie-moore-3
245,Keiwone Malone,Memphis,American,13,45,555,12.3,4,4,63,15.8,0,49,618,12.6,4,keiwone-malone-1
246,Joel Ruiz,Georgia State,Sun Belt,10,39,478,12.3,3,0,0,,0,39,478,12.3,3,joel-ruiz-1
247,Tim Crawley,San Jose State,MWC,11,35,430,12.3,1,32,107,3.3,1,67,537,8,2,tim-crawley-1
248,Aaron Burbridge,Michigan State,Big Ten,13,29,358,12.3,1,8,39,4.9,0,37,397,10.7,1,aaron-burbridge-1
249,Germone Hopper,Clemson,ACC,10,27,331,12.3,3,1,0,0,0,28,331,11.8,3,germone-hopper-1
250,Josh Harper,Fresno State,MWC,14,90,1097,12.2,7,2,-4,-2,0,92,1093,11.9,7,josh-harper-1
251,Kevonn Mabon,Ball State,MAC,12,59,717,12.2,5,5,54,10.8,1,64,771,12,6,kevonn-mabon-1
252,Chris Harper,California,Pac-12,12,52,634,12.2,6,5,17,3.4,0,57,651,11.4,6,chris-harper-3
253,Jordan Thompson,West Virginia,Big 12,13,49,598,12.2,2,6,37,6.2,0,55,635,11.5,2,jordan-thompson-2
254,Kaelin Clay,Utah,Pac-12,13,43,523,12.2,4,4,4,1,0,47,527,11.2,4,kaelin-clay-1
255,Paul Turner,Louisiana Tech,CUSA,12,42,514,12.2,4,0,0,,0,42,514,12.2,4,paul-turner-3
256,Durron Neal,Oklahoma,Big 12,12,42,513,12.2,3,2,19,9.5,0,44,532,12.1,3,durron-neal-1
257,Maika Mataele,UNLV,MWC,13,29,355,12.2,1,0,0,,0,29,355,12.2,1,maika-mataele-1
258,Dan Crimmins,Boston College,ACC,10,25,305,12.2,0,0,0,,0,25,305,12.2,0,dan-crimmins-1
259,Keevan Lucas,Tulsa,American,12,101,1219,12.1,11,7,66,9.4,0,108,1285,11.9,11,keevan-lucas-1
260,J.D. McKissic,Arkansas State,Sun Belt,10,52,629,12.1,0,9,115,12.8,1,61,744,12.2,1,jd-mckissic-1
261,Quan Bray,Auburn,SEC,13,39,471,12.1,4,9,74,8.2,1,48,545,11.4,5,quan-bray-1
262,Teldrick Morgan,New Mexico State,Sun Belt,11,75,903,12,7,2,16,8,0,77,919,11.9,7,teldrick-morgan-1
263,Jared Dangerfield,Western Kentucky,CUSA,13,69,825,12,11,0,0,,0,69,825,12,11,jared-dangerfield-1
264,Devon Hughes,Buffalo,MAC,10,43,515,12,7,0,0,,0,43,515,12,7,devon-hughes-1
265,Nick Jones,South Carolina,SEC,13,42,504,12,5,0,0,,0,42,504,12,5,nick-jones-2
266,Gerald Christian,Louisville,ACC,13,32,384,12,5,0,0,,0,32,384,12,5,gerald-christian-1
267,Ty Slanina,TCU,Big 12,11,32,383,12,2,0,0,,0,32,383,12,2,ty-slanina-1
268,Andrew Pratt,Akron,MAC,9,27,324,12,0,0,0,,0,27,324,12,0,andrew-pratt-1
269,Quincy Adeboyejo,Ole Miss,SEC,9,26,313,12,2,1,-1,-1,0,27,312,11.6,2,quincy-adeboyejo-1
270,Zach Wright,Rice,CUSA,9,25,299,12,3,0,0,,0,25,299,12,3,zach-wright-1
271,Willie McNeal,Western Kentucky,CUSA,12,56,666,11.9,8,0,0,,0,56,666,11.9,8,willie-mcneal-1
272,Issac Blakeney,Duke,ACC,13,47,559,11.9,7,0,0,,0,47,559,11.9,7,issac-blakeney-1
273,Ryan Timmons,Kentucky,SEC,11,45,536,11.9,2,5,-9,-1.8,0,50,527,10.5,2,ryan-timmons-1
274,Joshua Atkinson,Tulsa,American,12,35,416,11.9,0,0,0,,0,35,416,11.9,0,joshua-atkinson-1
275,Jameon Lewis,Mississippi State,SEC,9,32,380,11.9,2,7,56,8,0,39,436,11.2,2,jameon-lewis-1
276,Jabari Carr,San Jose State,MWC,9,30,356,11.9,3,0,0,,0,30,356,11.9,3,jabari-carr-1
277,Bishop Louie,Tulsa,American,11,23,274,11.9,1,7,100,14.3,1,30,374,12.5,2,bishop-louie-1
278,Ryan Burbrink,Bowling Green State,MAC,14,64,758,11.8,3,1,6,6,0,65,764,11.8,3,ryan-burbrink-1
279,Devin Funchess,Michigan,Big Ten,11,62,733,11.8,4,2,-11,-5.5,0,64,722,11.3,4,devin-funchess-1
280,Geremy Davis,Connecticut,American,10,44,521,11.8,3,0,0,,0,44,521,11.8,3,geremy-davis-1
281,Gregory Hogan,New Mexico State,Sun Belt,10,28,331,11.8,3,0,0,,0,28,331,11.8,3,gregory-hogan-1
282,Deontay Greenberry,Houston,American,13,72,841,11.7,6,0,0,,0,72,841,11.7,6,deontay-greenberry-1
283,River Cracraft,Washington State,Pac-12,9,66,771,11.7,8,0,0,,0,66,771,11.7,8,river-cracraft-1
284,Jerico Richardson,Nevada,MWC,11,56,655,11.7,3,0,4,,1,56,659,11.8,4,jerico-richardson-1
285,Bucky Hodges,Virginia Tech,ACC,13,45,526,11.7,7,7,20,2.9,0,52,546,10.5,7,bucky-hodges-1
286,Eli Rogers,Louisville,ACC,13,45,525,11.7,3,0,0,,0,45,525,11.7,3,eli-rogers-1
287,Jake Roh,Boise State,MWC,14,35,408,11.7,2,0,0,,0,35,408,11.7,2,jake-roh-1
288,Hunter Lee,Louisiana Tech,CUSA,11,29,338,11.7,3,5,18,3.6,0,34,356,10.5,3,hunter-lee-1
289,Mike McFarland,South Florida,American,10,27,315,11.7,0,0,0,,0,27,315,11.7,0,mike-mcfarland-1
290,Noel Thomas,Connecticut,American,8,26,305,11.7,4,0,0,,0,26,305,11.7,4,noel-thomas-1
291,Kai De La Cruz,Louisville,ACC,11,26,303,11.7,2,0,0,,0,26,303,11.7,2,kai-de-la-cruz-1
292,Maudrecus Humphrey,UAB,CUSA,11,24,281,11.7,0,2,1,0.5,0,26,282,10.8,0,maudrecus-humphrey-1
293,Deonte Welch,South Florida,American,11,23,269,11.7,0,2,-6,-3,0,25,263,10.5,0,deonte-welch-1
294,Daniel Braverman,Western Michigan,MAC,13,86,997,11.6,6,6,58,9.7,1,92,1055,11.5,7,daniel-braverman-1
295,Jonnu Smith,Florida International,CUSA,12,61,710,11.6,8,0,0,,0,61,710,11.6,8,jonnu-smith-1
296,Marcus Johnson,Texas,Big 12,13,27,313,11.6,1,0,0,,0,27,313,11.6,1,marcus-johnson-3
297,Darius Terrell,North Texas,CUSA,11,26,301,11.6,0,0,0,,0,26,301,11.6,0,darius-terrell-1
298,Shaq Washington,Cincinnati,American,13,66,761,11.5,4,8,23,2.9,0,74,784,10.6,4,shaq-washington-1
299,Malcome Kennedy,Texas A&M,SEC,11,53,611,11.5,6,1,-3,-3,0,54,608,11.3,6,malcome-kennedy-1
300,Simms McElfresh,Appalachian State,Sun Belt,12,42,484,11.5,5,4,20,5,2,46,504,11,7,simms-mcelfresh-1
301,Quinshad Davis,North Carolina,ACC,12,41,470,11.5,6,0,0,,0,41,470,11.5,6,quinshad-davis-1
302,Brandon Smith,Texas State,Sun Belt,11,36,414,11.5,1,0,0,,0,36,414,11.5,1,brandon-smith-7
303,Mike Davis,South Carolina,SEC,13,32,368,11.5,2,199,982,4.9,9,231,1350,5.8,11,mike-davis-9
304,Ben Lewis,Syracuse,ACC,9,24,275,11.5,1,0,0,,0,24,275,11.5,1,ben-lewis-2
305,Quinton Pedroza,Hawaii,MWC,11,59,674,11.4,3,1,9,9,0,60,683,11.4,3,quinton-pedroza-2
306,Pig Howard,Tennessee,SEC,13,54,618,11.4,1,15,96,6.4,2,69,714,10.3,3,pig-howard-1
307,Eric Frohnapfel,Marshall,CUSA,13,37,420,11.4,5,0,0,,0,37,420,11.4,5,eric-frohnapfel-1
308,Tyler Baker,Washington State,Pac-12,5,27,308,11.4,2,0,0,,0,27,308,11.4,2,tyler-baker-1
309,Nelson Spruce,Colorado,Pac-12,12,106,1198,11.3,12,1,2,2,0,107,1200,11.2,12,nelson-spruce-1
310,Rashon Ceaser,Louisiana-Monroe,Sun Belt,12,77,872,11.3,3,0,0,,0,77,872,11.3,3,rashon-ceaser-1
311,Deon Long,Maryland,Big Ten,13,51,575,11.3,2,1,9,9,0,52,584,11.2,2,deon-long-1
312,Bryce Treggs,California,Pac-12,12,52,583,11.2,6,1,0,0,0,53,583,11,6,bryce-treggs-1
313,Javorius Allen,USC,Pac-12,13,41,458,11.2,1,276,1489,5.4,11,317,1947,6.1,12,javorius-allen-1
314,Victor Bolden,Oregon State,Pac-12,11,72,798,11.1,2,19,118,6.2,0,91,916,10.1,2,victor-bolden-1
315,D.J. Foster,Arizona State,Pac-12,13,62,688,11.1,3,194,1081,5.6,9,256,1769,6.9,12,dj-foster-1
316,Duke Johnson,Miami (FL),ACC,13,38,421,11.1,3,242,1652,6.8,10,280,2073,7.4,13,duke-johnson-1
317,DaeSean Hamilton,Penn State,Big Ten,13,82,899,11,2,8,32,4,0,90,931,10.3,2,daesean-hamilton-1
318,Kenzee Jackson,Louisiana-Monroe,Sun Belt,12,79,866,11,4,0,0,,0,79,866,11,4,kenzee-jackson-1
319,Reginald Davis,Texas Tech,Big 12,10,29,318,11,5,0,0,,0,29,318,11,5,reginald-davis-1
320,Richard Montgomery,Idaho,Sun Belt,10,50,543,10.9,1,13,56,4.3,2,63,599,9.5,3,richard-montgomery-1
321,L.T. Smith,Akron,MAC,12,45,489,10.9,3,0,0,,0,45,489,10.9,3,lt-smith-1
322,Michael Bennett,Georgia,SEC,11,37,404,10.9,4,0,0,,0,37,404,10.9,4,michael-bennett-4
323,Jake Duzey,Iowa,Big Ten,11,36,392,10.9,3,0,0,,0,36,392,10.9,3,jake-duzey-1
324,Deandre Washington,Texas Tech,Big 12,12,30,328,10.9,2,188,1103,5.9,2,218,1431,6.6,4,deandre-washington-1
325,Mose Frazier,Memphis,American,13,47,506,10.8,3,11,68,6.2,0,58,574,9.9,3,mose-frazier-1
326,Bug Howard,North Carolina,ACC,12,42,455,10.8,2,0,0,,0,42,455,10.8,2,bug-howard-1
327,Rickey Galvin,Washington State,Pac-12,11,37,400,10.8,3,0,0,,0,37,400,10.8,3,rickey-galvin-1
328,Aregeros Turner,Northern Illinois,MAC,14,37,398,10.8,2,13,38,2.9,2,50,436,8.7,4,aregeros-turner-1
329,Daniel Lasco,California,Pac-12,12,33,356,10.8,2,210,1115,5.3,12,243,1471,6.1,14,daniel-lasco-1
330,Adam Shapiro,New Mexico State,Sun Belt,10,25,271,10.8,1,1,-26,-26,0,26,245,9.4,1,adam-shapiro-1
331,Kris White,Kent State,MAC,9,25,270,10.8,0,0,0,,0,25,270,10.8,0,kris-white-1
332,Casey Pierce,Kent State,MAC,11,60,641,10.7,6,0,0,,0,60,641,10.7,6,casey-pierce-1
333,Jay Ajayi,Boise State,MWC,14,50,535,10.7,4,347,1823,5.3,28,397,2358,5.9,32,jay-ajayi-1
334,Nick Harwell,Kansas,Big 12,12,44,470,10.7,5,2,7,3.5,0,46,477,10.4,5,nick-harwell-1
335,Hansel Wilson,San Jose State,MWC,12,39,417,10.7,3,1,-4,-4,0,40,413,10.3,3,hansel-wilson-1
336,Connor Hamlett,Oregon State,Pac-12,12,32,342,10.7,2,0,0,,0,32,342,10.7,2,connor-hamlett-1
337,Anthony Rice,Central Michigan,MAC,11,30,321,10.7,1,1,12,12,0,31,333,10.7,1,anthony-rice-2
338,Marquez North,Tennessee,SEC,8,30,320,10.7,4,0,0,,0,30,320,10.7,4,marquez-north-1
339,Ben Ijah,Texas State,Sun Belt,12,27,289,10.7,3,0,0,,0,27,289,10.7,3,ben-ijah-1
340,Paul Lasike,Brigham Young,Ind,13,25,267,10.7,2,79,364,4.6,7,104,631,6.1,9,paul-lasike-1
341,Zach D'Orazio,Akron,MAC,12,62,658,10.6,1,1,3,3,0,63,661,10.5,1,zach-dorazio-1
342,Jared Crump,Wake Forest,ACC,12,32,339,10.6,1,1,2,2,0,33,341,10.3,1,jared-crump-1
343,Ben Koyack,Notre Dame,Ind,13,30,317,10.6,2,0,0,,0,30,317,10.6,2,ben-koyack-1
344,Tyler Ervin,San Jose State,MWC,12,29,306,10.6,1,158,888,5.6,4,187,1194,6.4,5,tyler-ervin-1
345,Kyle Prater,Northwestern,Big Ten,11,51,535,10.5,2,0,0,,0,51,535,10.5,2,kyle-prater-1
346,Kenneth Scott,Utah,Pac-12,12,48,506,10.5,4,0,0,,0,48,506,10.5,4,kenneth-scott-1
347,Ed'Marques Batties,Middle Tennessee State,CUSA,12,45,474,10.5,3,2,28,14,0,47,502,10.7,3,edmarques-batties-1
348,Greg Watson,Fresno State,MWC,11,35,369,10.5,5,2,13,6.5,0,37,382,10.3,5,greg-watson-1
349,Wendell Smallwood,West Virginia,Big 12,13,31,326,10.5,0,148,722,4.9,2,179,1048,5.9,2,wendell-smallwood-1
350,Melvin Vaughn,Old Dominion,CUSA,8,30,315,10.5,3,0,0,,0,30,315,10.5,3,melvin-vaughn-1
351,Chris Shillings,Ball State,MAC,12,28,293,10.5,1,0,0,,0,28,293,10.5,1,chris-shillings-1
352,Elijah McGuire,Louisiana,Sun Belt,13,45,468,10.4,2,166,1264,7.6,14,211,1732,8.2,16,elijah-mcguire-1
353,Jesse James,Penn State,Big Ten,13,38,396,10.4,3,0,0,,0,38,396,10.4,3,jesse-james-1
354,Joseph Matthews,New Mexico State,Sun Belt,12,37,386,10.4,4,0,0,,0,37,386,10.4,4,joseph-matthews-1
355,Max McCaffrey,Duke,ACC,12,37,385,10.4,3,0,0,,0,37,385,10.4,3,max-mccaffrey-1
356,Al-Damion Riles,Louisiana,Sun Belt,12,34,354,10.4,1,3,5,1.7,0,37,359,9.7,1,al-damion-riles-1
357,Jaydon Mickens,Washington,Pac-12,14,60,617,10.3,4,17,103,6.1,2,77,720,9.4,6,jaydon-mickens-1
358,Lynquez Blair,Georgia State,Sun Belt,10,52,538,10.3,6,1,-17,-17,0,53,521,9.8,6,lynquez-blair-1
359,E.J. Scott,Wake Forest,ACC,12,50,513,10.3,4,6,39,6.5,1,56,552,9.9,5,ej-scott-1
360,Von Pearson,Tennessee,SEC,11,38,393,10.3,5,8,27,3.4,0,46,420,9.1,5,von-pearson-1
361,Justin Podrabsky,Idaho,Sun Belt,11,37,380,10.3,1,0,0,,0,37,380,10.3,1,justin-podrabsky-1
362,Davon Grayson,East Carolina,American,10,25,257,10.3,0,0,0,,0,25,257,10.3,0,davon-grayson-1
363,Zay Jones,East Carolina,American,13,81,830,10.2,5,0,0,,0,81,830,10.2,5,isaiah-jones-2
364,Rannell Hall,UCF,American,10,49,500,10.2,0,25,129,5.2,1,74,629,8.5,1,rannell-hall-1
365,Max Morrison,Cincinnati,American,12,45,458,10.2,4,0,0,,0,45,458,10.2,4,max-morrison-1
366,Kennard Backman,UAB,CUSA,12,39,399,10.2,3,0,0,,0,39,399,10.2,3,kennard-backman-1
367,Demarcus Ayers,Houston,American,13,33,335,10.2,2,2,4,2,0,35,339,9.7,2,demarcus-ayers-1
368,Malik Turner,Illinois,Big Ten,8,25,256,10.2,1,0,0,,0,25,256,10.2,1,malik-turner-1
369,Dan Vitale,Northwestern,Big Ten,11,40,402,10.1,2,1,0,0,0,41,402,9.8,2,dan-vitale-1
370,David Porter,TCU,Big 12,12,39,392,10.1,3,0,0,,0,39,392,10.1,3,david-porter-1
371,D.D. Goodson,Colorado,Pac-12,9,38,382,10.1,2,1,7,7,0,39,389,10,2,dd-goodson-1
372,Boone Niederhofer,Texas A&M,SEC,8,29,293,10.1,1,0,0,,0,29,293,10.1,1,boone-niederhofer-1
373,Maurice Harris,California,Pac-12,9,25,252,10.1,2,0,0,,0,25,252,10.1,2,maurice-harris-3
374,Matt James,Wake Forest,ACC,9,40,401,10,0,0,0,,0,40,401,10,0,matt-james-1
375,Matt Dayes,North Carolina State,ACC,13,32,321,10,5,104,573,5.5,8,136,894,6.6,13,matt-dayes-1
376,Jacob Martinez,Buffalo,MAC,11,28,280,10,3,2,1,0.5,0,30,281,9.4,3,jacob-martinez-1
377,Ty Montgomery,Stanford,Pac-12,11,61,604,9.9,3,23,144,6.3,1,84,748,8.9,4,ty-montgomery-1
378,Kevonte Martin-Manley,Iowa,Big Ten,13,52,517,9.9,2,0,0,,0,52,517,9.9,2,kevonte-martin-manley-1
379,Bruce Natson,Utah State,MWC,13,51,504,9.9,2,50,498,10,3,101,1002,9.9,5,bruce-natson-1
380,Jack Tabb,North Carolina,ACC,11,26,257,9.9,3,0,0,,0,26,257,9.9,3,jack-tabb-1
381,Malcolm Lewis,Miami (FL),ACC,11,25,248,9.9,1,0,0,,0,25,248,9.9,1,malcolm-lewis-2
382,Jaxon Shipley,Texas,Big 12,12,59,577,9.8,1,0,0,,0,59,577,9.8,1,jaxon-shipley-1
383,Cam Serigne,Wake Forest,ACC,12,54,531,9.8,5,0,0,,0,54,531,9.8,5,cam-serigne-1
384,Bradley Miller,Texas State,Sun Belt,12,44,431,9.8,1,0,0,,0,44,431,9.8,1,bradley-miller-1
385,Aaron Jones,UTEP,CUSA,12,30,293,9.8,3,242,1321,5.5,11,272,1614,5.9,14,aaron-jones-6
386,Casey Martin,Southern Mississippi,CUSA,11,55,531,9.7,2,0,0,,0,55,531,9.7,2,casey-martin-1
387,Shay Fields,Colorado,Pac-12,12,50,486,9.7,4,4,24,6,1,54,510,9.4,5,shay-fields-1
388,Chandler Worthy,Troy,Sun Belt,12,44,428,9.7,3,12,55,4.6,0,56,483,8.6,3,chandler-worthy-1
389,Latevius Rayford,Vanderbilt,SEC,11,36,350,9.7,1,1,8,8,0,37,358,9.7,1,latevius-rayford-1
390,Ernest Calhoun,Kent State,MAC,11,33,319,9.7,1,6,-20,-3.3,0,39,299,7.7,1,ernest-calhoun-1
391,C.J. Best,Texas State,Sun Belt,12,37,355,9.6,2,36,326,9.1,1,73,681,9.3,3,cj-best-1
392,Roderick Proctor,Memphis,American,11,27,259,9.6,1,7,-16,-2.3,0,34,243,7.1,1,roderick-proctor-1
393,Ricky Seals-Jones,Texas A&M,SEC,11,49,465,9.5,4,0,0,,0,49,465,9.5,4,ricky-seals-jones-1
394,Teddy Veal,Tulane,American,12,40,381,9.5,1,1,24,24,1,41,405,9.9,2,teddy-veal-1
395,Taylor Barnhill,UNLV,MWC,10,29,275,9.5,2,0,0,,0,29,275,9.5,2,taylor-barnhill-1
396,Michiah Quick,Oklahoma,Big 12,8,25,237,9.5,1,4,6,1.5,0,29,243,8.4,1,michiah-quick-1
397,Dustin Creel,Eastern Michigan,MAC,8,24,228,9.5,0,0,0,,0,24,228,9.5,0,dustin-creel-1
398,Jereme Jones,South Alabama,Sun Belt,13,36,338,9.4,2,0,0,,0,36,338,9.4,2,jereme-jones-1
399,Lucky Whitehead,Florida Atlantic,CUSA,12,76,706,9.3,6,21,210,10,1,97,916,9.4,7,lucky-whitehead-1
400,Richy Turner,Nevada,MWC,13,63,587,9.3,4,1,-4,-4,0,64,583,9.1,4,richy-turner-1
401,Leon Allen,Western Kentucky,CUSA,13,51,476,9.3,3,272,1542,5.7,13,323,2018,6.2,16,leon-allen-1
402,Deon Watson,Idaho,Sun Belt,10,37,343,9.3,1,0,0,,0,37,343,9.3,1,deon-watson-1
403,Steven Walker,Colorado State,MWC,12,30,279,9.3,4,0,0,,0,30,279,9.3,4,steven-walker-1
404,Bryce Bobo,Colorado,Pac-12,10,23,215,9.3,3,1,-3,-3,0,24,212,8.8,3,bryce-bobo-1
405,Tony Jones,Northwestern,Big Ten,10,35,323,9.2,1,3,17,5.7,0,38,340,8.9,1,tony-jones-1
406,Levi Norwood,Baylor,Big 12,10,35,319,9.1,2,1,4,4,0,36,323,9,2,levi-norwood-1
407,Tyreek Hill,Oklahoma State,Big 12,12,31,281,9.1,1,102,534,5.2,1,133,815,6.1,2,tyreek-hill-1
408,Karlos Williams,Florida State,ACC,12,29,265,9.1,1,150,689,4.6,11,179,954,5.3,12,karlos-williams-1
409,Fransohn Bickley,Akron,MAC,8,29,264,9.1,0,1,-5,-5,0,30,259,8.6,0,fransohn-bickley-1
410,Robert Lewis,Washington State,Pac-12,11,41,370,9,2,0,0,,0,41,370,9,2,robert-lewis-7
411,Wayne Beadle,Houston,American,9,27,242,9,0,0,0,,0,27,242,9,0,wayne-beadle-1
412,Tyler Winston,San Jose State,MWC,12,78,694,8.9,5,0,0,,0,78,694,8.9,5,tyler-winston-1
413,Landon Smith,Ohio,MAC,7,24,213,8.9,2,1,8,8,0,25,221,8.8,2,landon-smith-2
414,Jarred Gipson,Nevada,MWC,12,33,291,8.8,4,0,0,,0,33,291,8.8,4,jarred-gipson-1
415,Gabe Fuselier,Louisiana,Sun Belt,10,30,264,8.8,2,0,0,,0,30,264,8.8,2,gabe-fuselier-1
416,Aaron Grubb,UTSA,CUSA,10,23,202,8.8,0,2,2,1,0,25,204,8.2,0,aaron-grubb-1
417,Shane Williams-Rhodes,Boise State,MWC,13,68,585,8.6,7,15,179,11.9,0,83,764,9.2,7,shane-williams-rhodes-1
418,Robert Lowe,Texas State,Sun Belt,11,24,207,8.6,1,185,1091,5.9,12,209,1298,6.2,13,robert-lowe-2
419,Josh Ferguson,Illinois,Big Ten,13,50,427,8.5,2,146,735,5,8,196,1162,5.9,10,josh-ferguson-3
420,E.J. Bibbs,Iowa State,Big 12,10,45,382,8.5,8,0,0,,0,45,382,8.5,8,ej-bibbs-1
421,Autrey Golden,UTEP,CUSA,13,31,263,8.5,2,15,101,6.7,0,46,364,7.9,2,autrey-golden-1
422,Willie Byrn,Virginia Tech,ACC,12,47,388,8.3,0,0,0,,0,47,388,8.3,0,willie-byrn-1
423,Breon Allen,East Carolina,American,12,35,289,8.3,1,134,869,6.5,8,169,1158,6.9,9,breon-allen-1
424,Damon Bullock,Iowa,Big Ten,10,32,265,8.3,0,27,74,2.7,0,59,339,5.7,0,damon-bullock-1
425,Miles Shuler,Northwestern,Big Ten,8,23,190,8.3,0,6,24,4,1,29,214,7.4,1,miles-shuler-1
426,Joshua Bowen,New Mexico State,Sun Belt,10,41,336,8.2,1,0,0,,0,41,336,8.2,1,joshua-bowen-1
427,Aaron Wimberly,Iowa State,Big 12,11,27,222,8.2,1,147,642,4.4,7,174,864,5,8,aaron-wimberly-1
428,Deion Sanders Jr.,SMU,American,9,23,188,8.2,0,0,0,,0,23,188,8.2,0,deion-sanders-jr-1
429,Dontrell Hilliard,Tulane,American,12,30,244,8.1,1,97,452,4.7,3,127,696,5.5,4,dontrell-hilliard-1
430,Jahwan Edwards,Ball State,MAC,12,29,236,8.1,0,262,1252,4.8,12,291,1488,5.1,12,jahwan-edwards-1
431,John Christopher,Temple,American,9,24,194,8.1,0,0,0,,0,24,194,8.1,0,john-christopher-1
432,Justin Sinz,Purdue,Big Ten,12,32,257,8,2,0,0,,0,32,257,8,2,justin-sinz-1
433,Malcolm Mitchell,Georgia,SEC,8,31,248,8,3,0,0,,0,31,248,8,3,malcolm-mitchell-2
434,Ryan Jackson,Houston,American,13,25,199,8,2,112,620,5.5,5,137,819,6,7,ryan-jackson-1
435,Heath Jackson,Bowling Green State,MAC,10,34,270,7.9,0,0,0,,0,34,270,7.9,0,heath-jackson-1
436,Terron Ward,Oregon State,Pac-12,10,29,229,7.9,0,133,696,5.2,10,162,925,5.7,10,terron-ward-1
437,Davonte' Neal,Arizona,Pac-12,11,27,214,7.9,2,1,6,6,0,28,220,7.9,2,davonte-neal-1
438,Brandon Burks,Troy,Sun Belt,11,23,181,7.9,1,96,584,6.1,3,119,765,6.4,4,brandon-burks-1
439,Devin Lucien,UCLA,Pac-12,12,29,225,7.8,2,1,34,34,0,30,259,8.6,2,devin-lucien-1
440,Bill Belton,Penn State,Big Ten,13,26,201,7.7,1,125,526,4.2,6,151,727,4.8,7,bill-belton-1
441,Paul Perkins,UCLA,Pac-12,13,26,201,7.7,2,250,1572,6.3,9,276,1773,6.4,11,paul-perkins-1
442,Jalen Richard,Southern Mississippi,CUSA,7,24,184,7.7,1,40,236,5.9,1,64,420,6.6,2,jalen-richard-1
443,Devin Fuller,UCLA,Pac-12,13,59,447,7.6,1,1,-2,-2,0,60,445,7.4,1,devin-fuller-1
444,Jarvis West,Iowa State,Big 12,11,46,349,7.6,1,1,4,4,0,47,353,7.5,1,jarvis-west-1
445,Marcus Murphy,Missouri,SEC,14,28,212,7.6,1,177,924,5.2,4,205,1136,5.5,5,marcus-murphy-1
446,Michael Gordon,Arkansas State,Sun Belt,11,25,191,7.6,1,159,1100,6.9,13,184,1291,7,14,michael-gordon-1
447,Devin Campbell,Buffalo,MAC,10,24,182,7.6,4,33,161,4.9,0,57,343,6,4,devin-campbell-1
448,Jamal Morrow,Washington State,Pac-12,12,61,460,7.5,0,87,351,4,0,148,811,5.5,0,jamal-morrow-1
449,Larry Rose III,New Mexico State,Sun Belt,11,23,172,7.5,1,186,1102,5.9,9,209,1274,6.1,10,larry-rose-iii-1
450,Nick Holley,Kent State,MAC,11,27,199,7.4,1,125,516,4.1,3,152,715,4.7,4,nick-holley-1
451,Devontae Booker,Utah,Pac-12,13,43,306,7.1,2,292,1512,5.2,10,335,1818,5.4,12,devontae-booker-1
452,Stephen Nelson,SMU,American,10,28,200,7.1,0,0,0,,0,28,200,7.1,0,stephen-nelson-1
453,Darius Joseph,SMU,American,10,54,379,7,2,1,4,4,0,55,383,7,2,darius-joseph-1
454,Taquan Mizzell,Virginia,ACC,12,39,271,6.9,0,64,280,4.4,2,103,551,5.3,2,taquan-mizzell-1
455,Storm Woods,Oregon State,Pac-12,10,26,179,6.9,1,121,766,6.3,5,147,945,6.4,6,storm-woods-1
456,Kam Jones,UTSA,CUSA,12,34,232,6.8,0,25,69,2.8,1,59,301,5.1,1,kam-jones-1
457,Joshua Quezada,Fresno State,MWC,13,33,223,6.8,1,134,525,3.9,5,167,748,4.5,6,joshua-quezada-1
458,Adam Humphries,Clemson,ACC,13,30,204,6.8,0,5,5,1,1,35,209,6,1,adam-humphries-1
459,Travis Greene,Bowling Green State,MAC,12,27,175,6.5,1,180,949,5.3,12,207,1124,5.4,13,travis-greene-1
460,Jalen Hurd,Tennessee,SEC,13,35,221,6.3,2,190,899,4.7,5,225,1120,5,7,jalen-hurd-1
461,Tony Jones,Colorado,Pac-12,12,24,151,6.3,0,94,403,4.3,3,118,554,4.7,3,tony-jones-7
462,Gerard Johnson,Old Dominion,CUSA,11,24,149,6.2,0,100,493,4.9,1,124,642,5.2,1,gerard-johnson-1
463,Akeem Hunt,Purdue,Big Ten,12,48,293,6.1,2,173,949,5.5,6,221,1242,5.6,8,akeem-hunt-1
464,Tyler Cain,Louisiana-Monroe,Sun Belt,12,45,273,6.1,0,63,214,3.4,0,108,487,4.5,0,tyler-cain-1
465,Kevin Parks,Virginia,ACC,12,30,179,6,2,189,745,3.9,4,219,924,4.2,6,kevin-parks-1
466,Kenneth Harper,Temple,American,12,27,158,5.9,1,87,307,3.5,5,114,465,4.1,6,kenneth-harper-1
467,Tevin Coleman,Indiana,Big Ten,12,25,141,5.6,0,270,2036,7.5,15,295,2177,7.4,15,tevin-coleman-1
468,T.J. Logan,North Carolina,ACC,13,26,144,5.5,0,119,582,4.9,3,145,726,5,3,tj-logan-1
469,Sherman Badie,Tulane,American,12,24,108,4.5,1,121,688,5.7,3,145,796,5.5,4,sherman-badie-1
470,Marteze Waller,Fresno State,MWC,14,27,120,4.4,0,225,1368,6.1,11,252,1488,5.9,11,marteze-waller-1