Rk,Player,School,Conf,G,Rec,Yds,Avg,TD,Att,Yds,Avg,TD,Plays,Yds,Avg,TD,-9999
1,Jalen Robinette,Air Force,MWC,12,35,959,27.4,6,0,0,,0,35,959,27.4,6,jalen-robinette-1
2,Jester Weah,Pitt,ACC,13,36,870,24.2,10,0,0,,0,36,870,24.2,10,jester-weah-1
3,Jaylen Smith,Louisville,ACC,12,27,599,22.2,6,0,0,,0,27,599,22.2,6,jaylen-smith-1
4,Shelton Gibson,West Virginia,Big 12,13,43,951,22.1,8,2,29,14.5,0,45,980,21.8,8,shelton-gibson-1
5,Olabisi Johnson,Colorado State,MWC,11,28,613,21.9,4,1,13,13,0,29,626,21.6,4,olabisi-johnson-1
6,Jeff Badet,Kentucky,SEC,13,31,670,21.6,4,1,25,25,0,32,695,21.7,4,jeff-badet-1
7,Micah Holder,San Diego State,MWC,10,27,581,21.5,5,0,0,,0,27,581,21.5,5,micah-holder-1
8,Cedric Wilson,Boise State,MWC,12,56,1129,20.2,11,3,7,2.3,0,59,1136,19.3,11,cedric-wilson-3
9,Cody Thompson,Toledo,MAC,13,64,1269,19.8,11,0,0,,0,64,1269,19.8,11,cody-thompson-1
10,Dieuly Aristilde,Eastern Michigan,MAC,5,25,492,19.7,2,0,0,,0,25,492,19.7,2,dieuly-aristilde-1
11,James Washington,Oklahoma State,Big 12,13,71,1380,19.4,10,4,28,7,0,75,1408,18.8,10,james-washington-5
12,Josh Malone,Tennessee,SEC,13,50,972,19.4,11,0,0,,0,50,972,19.4,11,josh-malone-1
13,Deangelo Yancey,Purdue,Big Ten,12,49,951,19.4,10,0,0,,0,49,951,19.4,10,deangelo-yancey-1
14,Stephen Louis,North Carolina State,ACC,12,35,678,19.4,2,1,3,3,0,36,681,18.9,2,stephen-louis-1
15,Jon'Vea Johnson,Toledo,MAC,12,40,773,19.3,10,0,0,,0,40,773,19.3,10,jonvea-johnson-1
16,Jalen Williams,Massachusetts,Ind,10,27,520,19.3,6,0,0,,0,27,520,19.3,6,jalen-williams-3
17,Rokeem Williams,Miami (OH),MAC,10,26,501,19.3,3,0,0,,0,26,501,19.3,3,rokeem-williams-1
18,Blake Mack,Arkansas State,Sun Belt,11,34,652,19.2,3,0,0,,0,34,652,19.2,3,blake-mack-1
19,Dede Westbrook,Oklahoma,Big 12,13,80,1524,19.1,17,10,101,10.1,0,90,1625,18.1,17,dede-westbrook-1
20,Ahmmon Richards,Miami (FL),ACC,13,49,934,19.1,3,2,8,4,0,51,942,18.5,3,ahmmon-richards-1
21,Deon Cain,Clemson,ACC,15,38,724,19.1,9,0,0,,0,38,724,19.1,9,deon-cain-1
22,Josh Stewart,UTSA,CUSA,11,36,682,18.9,5,0,0,,0,36,682,18.9,5,josh-stewart-2
23,RJ Turner,Louisiana-Monroe,Sun Belt,9,23,433,18.8,3,0,0,,0,23,433,18.8,3,rj-turner-1
24,Carlos Henderson,Louisiana Tech,CUSA,13,82,1535,18.7,19,14,133,9.5,2,96,1668,17.4,21,carlos-henderson-1
25,Allen Staggers,Southern Mississippi,CUSA,13,63,1165,18.5,7,3,39,13,0,66,1204,18.2,7,allen-staggers-1
26,Chico McClatcher,Washington,Pac-12,12,31,574,18.5,5,18,131,7.3,1,49,705,14.4,6,chico-mcclatcher-1
27,Kevin Stepherson,Notre Dame,Ind,10,25,462,18.5,5,0,0,,0,25,462,18.5,5,kevin-stepherson-1
28,Tanner Gentry,Wyoming,MWC,14,72,1326,18.4,14,6,30,5,0,78,1356,17.4,14,tanner-gentry-1
29,Nick Westbrook,Indiana,Big Ten,12,54,995,18.4,6,1,3,3,1,55,998,18.1,7,nick-westbrook-1
30,Jimmy Williams,East Carolina,American,12,45,818,18.2,8,0,0,,0,45,818,18.2,8,jimmy-williams-9
31,Johnathon Johnson,Missouri,SEC,12,24,435,18.1,2,4,114,28.5,0,28,549,19.6,2,johnathon-johnson-2
32,Taj Williams,TCU,Big 12,12,39,702,18,5,0,0,,0,39,702,18,5,taj-williams-1
33,Shun Brown,Arizona,Pac-12,12,29,521,18,3,2,62,31,0,31,583,18.8,3,shun-brown-1
34,D.J. Chark,LSU,SEC,11,26,466,17.9,3,12,122,10.2,2,38,588,15.5,5,dj-chark-1
35,Jordan Frysinger,Idaho,Sun Belt,8,26,465,17.9,3,0,0,,0,26,465,17.9,3,jordan-frysinger-1
36,Taywan Taylor,Western Kentucky,CUSA,14,98,1730,17.7,17,6,36,6,0,104,1766,17,17,taywan-taylor-1
37,Kevin Kutchera,South Alabama,Sun Belt,11,30,532,17.7,1,0,0,,0,30,532,17.7,1,kevin-kutchera-1
38,Adonis Jennings,Temple,American,11,27,474,17.6,4,7,81,11.6,0,34,555,16.3,4,adonis-jennings-1
39,Nicholas Norris,Western Kentucky,CUSA,14,76,1318,17.3,14,13,222,17.1,1,89,1540,17.3,15,nicholas-norris-1
40,Donald Gray,Mississippi State,SEC,12,41,709,17.3,5,0,0,,0,41,709,17.3,5,donald-gray-1
41,Trey Hartley,San Jose State,MWC,9,33,572,17.3,4,1,18,18,0,34,590,17.4,4,trey-hartley-1
42,Raelon Singleton,Utah,Pac-12,12,27,464,17.2,4,0,0,,0,27,464,17.2,4,raelon-singleton-1
43,James Quick,Louisville,ACC,12,45,769,17.1,6,0,0,,0,45,769,17.1,6,james-quick-1
44,Michael Clark,Marshall,CUSA,11,37,632,17.1,5,0,0,,0,37,632,17.1,5,michael-clark-1
45,Jamari Staples,Louisville,ACC,11,36,615,17.1,2,0,0,,0,36,615,17.1,2,jamari-staples-1
46,Kelvin Harmon,North Carolina State,ACC,10,27,462,17.1,5,0,0,,0,27,462,17.1,5,kelvin-harmon-1
47,Ricky Jeune,Georgia Tech,ACC,11,25,427,17.1,1,1,40,40,0,26,467,18,1,ricky-jeune-1
48,Josh Reynolds,Texas A&M,SEC,13,61,1039,17,12,0,0,,0,61,1039,17,12,josh-reynolds-1
49,Deon Watson,Idaho,Sun Belt,12,41,695,17,3,0,0,,0,41,695,17,3,deon-watson-1
50,Xavier Brown,Louisiana-Monroe,Sun Belt,11,25,425,17,4,0,0,,0,25,425,17,4,xavier-brown-2
51,Keon Hatcher,Arkansas,SEC,12,44,743,16.9,8,4,7,1.8,0,48,750,15.6,8,keon-hatcher-1
52,Dondre Daley,Iowa State,Big 12,11,24,406,16.9,3,0,0,,0,24,406,16.9,3,dondre-daley-1
53,Jonathan Giles,Texas Tech,Big 12,11,69,1158,16.8,13,0,0,,0,69,1158,16.8,13,jonathan-giles-1
54,Josh Magee,South Alabama,Sun Belt,11,49,822,16.8,5,0,0,,0,49,822,16.8,5,josh-magee-1
55,Michael Gallup,Colorado State,MWC,13,76,1272,16.7,14,4,15,3.8,0,80,1287,16.1,14,michael-gallup-1
56,James Gardner,Miami (OH),MAC,11,45,750,16.7,6,0,0,,0,45,750,16.7,6,james-gardner-1
57,Chris Godwin,Penn State,Big Ten,13,59,982,16.6,11,1,13,13,0,60,995,16.6,11,chris-godwin-1
58,Equanimeous St. Brown,Notre Dame,Ind,12,58,961,16.6,9,0,0,,0,58,961,16.6,9,equanimeous-st-brown-1
59,Ventell Bryant,Temple,American,11,54,895,16.6,4,0,0,,0,54,895,16.6,4,ventell-bryant-1
60,Devonte Boyd,UNLV,MWC,9,45,746,16.6,4,0,0,,0,45,746,16.6,4,devonte-boyd-1
61,Jhajuan Seales,Oklahoma State,Big 12,12,37,615,16.6,4,1,3,3,0,38,618,16.3,4,jhajuan-seales-1
62,Trey Griffey,Arizona,Pac-12,10,23,382,16.6,2,0,0,,0,23,382,16.6,2,trey-griffey-1
63,Scott Orndoff,Pitt,ACC,12,35,579,16.5,5,0,0,,0,35,579,16.5,5,scott-orndoff-1
64,Travis Fulgham,Old Dominion,CUSA,12,29,478,16.5,8,0,0,,0,29,478,16.5,8,travis-fulgham-1
65,Courtland Sutton,SMU,American,12,76,1246,16.4,10,0,0,,0,76,1246,16.4,10,courtland-sutton-1
66,Jerome Lane,Akron,MAC,12,62,1018,16.4,6,0,0,,0,62,1018,16.4,6,jerome-lane-1
67,Sebastian Smith,Ohio,MAC,13,55,900,16.4,4,1,5,5,0,56,905,16.2,4,sebastian-smith-1
68,Papi White,Ohio,MAC,12,41,672,16.4,6,47,206,4.4,3,88,878,10,9,papi-white-1
69,Temi Alaka,Rice,CUSA,9,28,458,16.4,2,0,0,,0,28,458,16.4,2,temi-alaka-1
70,Auden Tate,Florida State,ACC,10,25,409,16.4,6,0,0,,0,25,409,16.4,6,auden-tate-1
71,J'Mon Moore,Missouri,SEC,12,62,1012,16.3,8,0,0,,1,62,1012,16.3,9,jmon-moore-2
72,Nyqwan Murray,Florida State,ACC,9,27,441,16.3,5,0,0,,0,27,441,16.3,5,nyqwan-murray-1
73,DeAndre Thompkins,Penn State,Big Ten,10,27,440,16.3,1,0,0,,0,27,440,16.3,1,deandre-thompkins-1
74,Keke Coutee,Texas Tech,Big 12,12,55,890,16.2,7,3,2,0.7,1,58,892,15.4,8,keke-coutee-1
75,David Njoku,Miami (FL),ACC,12,43,698,16.2,8,0,0,,0,43,698,16.2,8,david-njoku-1
76,Byron Pringle,Kansas State,Big 12,13,39,631,16.2,4,3,12,4,0,42,643,15.3,4,byron-pringle-1
77,Chris Platt,Baylor,Big 12,12,35,567,16.2,4,1,8,8,0,36,575,16,4,chris-platt-1
78,Elijah King,Texas State,Sun Belt,9,28,453,16.2,2,0,0,,0,28,453,16.2,2,elijah-king-1
79,Phil Mayhue,Memphis,American,12,42,677,16.1,4,0,0,,0,42,677,16.1,4,phil-mayhue-1
80,Jacob Hollister,Wyoming,MWC,12,32,515,16.1,7,1,2,2,0,33,517,15.7,7,jacob-hollister-1
81,Jared Cornelius,Arkansas,SEC,11,32,515,16.1,4,13,53,4.1,1,45,568,12.6,5,jared-cornelius-1
82,Ardarius Stewart,Alabama,SEC,12,54,864,16,8,8,68,8.5,0,62,932,15,8,ardarius-stewart-1
83,Ricky Jones,Indiana,Big Ten,13,53,848,16,3,1,5,5,0,54,853,15.8,3,ricky-jones-1
84,Jordan Leggett,Clemson,ACC,13,46,736,16,7,0,0,,0,46,736,16,7,jordan-leggett-1
85,Nate Iese,UCLA,Pac-12,8,25,400,16,4,0,0,,0,25,400,16,4,nate-iese-1
86,Thomas Sperbeck,Boise State,MWC,13,80,1272,15.9,9,11,53,4.8,0,91,1325,14.6,9,thomas-sperbeck-1
87,Shaedon Meadors,Appalachian State,Sun Belt,12,45,716,15.9,2,0,0,,0,45,716,15.9,2,shaedon-meadors-1
88,Kerry Thomas,UTSA,CUSA,11,35,555,15.9,8,1,2,2,0,36,557,15.5,8,kerry-thomas-1
89,Amba Etta-Tawo,Syracuse,ACC,12,94,1482,15.8,14,0,0,,0,94,1482,15.8,14,amba-etta-tawo-1
90,Shay Fields,Colorado,Pac-12,14,56,883,15.8,9,1,12,12,0,57,895,15.7,9,shay-fields-1
91,Jamire Jordan,Fresno State,MWC,12,45,713,15.8,2,17,83,4.9,1,62,796,12.8,3,jamire-jordan-1
92,Tim Patrick,Utah,Pac-12,10,45,711,15.8,5,0,0,,0,45,711,15.8,5,tim-patrick-2
93,Jamir Tillman,Navy,American,13,40,631,15.8,2,2,14,7,0,42,645,15.4,2,jamir-tillman-1
94,Chris Lacy,Oklahoma State,Big 12,12,31,489,15.8,3,0,0,,0,31,489,15.8,3,chris-lacy-2
95,Mark Andrews,Oklahoma,Big 12,12,31,489,15.8,7,0,0,,0,31,489,15.8,7,mark-andrews-1
96,Jake Maulhardt,Wyoming,MWC,13,39,614,15.7,4,0,0,,0,39,614,15.7,4,jake-maulhardt-1
97,Justin Holmes,San Jose State,MWC,12,39,613,15.7,3,0,0,,0,39,613,15.7,3,justin-holmes-2
98,Tony Stevens,Auburn,SEC,9,31,487,15.7,3,0,0,,0,31,487,15.7,3,tony-stevens-1
99,Cameron Echols-Luper,Arkansas State,Sun Belt,13,26,407,15.7,1,7,8,1.1,0,33,415,12.6,1,cameron-echols-luper-1
100,Bug Howard,North Carolina,ACC,12,53,827,15.6,8,0,0,,0,53,827,15.6,8,bug-howard-1
101,Damore'ea Stringfellow,Ole Miss,SEC,12,46,716,15.6,6,0,0,,0,46,716,15.6,6,damoreea-stringfellow-1
102,Richie James,Middle Tennessee State,CUSA,13,105,1625,15.5,12,38,339,8.9,4,143,1964,13.7,16,richie-james-1
103,Corey Davis,Western Michigan,MAC,14,97,1500,15.5,19,1,0,0,0,98,1500,15.3,19,corey-davis-3
104,Dante Pettis,Washington,Pac-12,13,53,822,15.5,15,0,0,,0,53,822,15.5,15,dante-pettis-1
105,D.J. Moore,Maryland,Big Ten,13,41,637,15.5,6,11,55,5,0,52,692,13.3,6,dj-moore-3
106,Keith Kirkwood,Temple,American,14,42,648,15.4,4,2,20,10,0,44,668,15.2,4,keith-kirkwood-1
107,Tyree McCants,South Florida,American,11,25,384,15.4,4,2,12,6,0,27,396,14.7,4,tyree-mccants-1
108,Demetris Robertson,California,Pac-12,12,50,767,15.3,7,0,0,,0,50,767,15.3,7,demetris-robertson-1
109,Jonathan Duhart,Old Dominion,CUSA,13,48,735,15.3,9,0,0,,0,48,735,15.3,9,jonathan-duhart-1
110,Austin Wolf,Akron,MAC,12,36,550,15.3,5,0,0,,0,36,550,15.3,5,austin-wolf-1
111,Corey Willis,Central Michigan,MAC,13,72,1091,15.2,9,2,4,2,0,74,1095,14.8,9,corey-willis-1
112,Carrington Thompson,Western Michigan,MAC,13,42,637,15.2,6,0,0,,0,42,637,15.2,6,carrington-thompson-1
113,Anthony Miller,Memphis,American,13,95,1434,15.1,14,12,69,5.8,1,107,1503,14,15,anthony-miller-6
114,Marcus Kemp,Hawaii,MWC,14,73,1100,15.1,8,0,0,,0,73,1100,15.1,8,marcus-kemp-1
115,Amara Darboh,Michigan,Big Ten,13,57,862,15.1,7,0,0,,0,57,862,15.1,7,amara-darboh-1
116,Jordan Lasley,UCLA,Pac-12,11,41,620,15.1,5,0,0,,0,41,620,15.1,5,jordan-lasley-1
117,Ian Sadler,Texas Tech,Big 12,8,24,363,15.1,0,0,0,,0,24,363,15.1,0,ian-sadler-1
118,Tre'Quan Smith,UCF,American,12,57,853,15,5,0,0,,0,57,853,15,5,trequan-smith-1
119,Travis Rudolph,Florida State,ACC,13,56,840,15,7,0,0,,0,56,840,15,7,travis-rudolph-1
120,Garrett Johnson,Kentucky,SEC,13,39,585,15,5,0,0,,0,39,585,15,5,garrett-johnson-3
121,R.J. Shelton,Michigan State,Big Ten,12,53,789,14.9,5,18,121,6.7,0,71,910,12.8,5,rj-shelton-1
122,DaeSean Hamilton,Penn State,Big Ten,12,34,506,14.9,1,1,-12,-12,0,35,494,14.1,1,daesean-hamilton-1
123,Allen Lazard,Iowa State,Big 12,12,69,1018,14.8,7,0,0,,0,69,1018,14.8,7,allen-lazard-1
124,Devin Gray,Cincinnati,American,12,58,860,14.8,5,3,-2,-0.7,0,61,858,14.1,5,devin-gray-1
125,Malik Turner,Illinois,Big Ten,11,48,712,14.8,6,2,5,2.5,0,50,717,14.3,6,malik-turner-1
126,Jazz Peavy,Wisconsin,Big Ten,14,43,635,14.8,5,21,318,15.1,1,64,953,14.9,6,jazz-peavy-1
127,Dalvin Cook,Florida State,ACC,13,33,488,14.8,1,288,1765,6.1,19,321,2253,7,20,dalvin-cook-1
128,Keevan Lucas,Tulsa,American,13,81,1180,14.6,15,8,45,5.6,0,89,1225,13.8,15,keevan-lucas-1
129,Zach Pascal,Old Dominion,CUSA,13,65,946,14.6,9,23,145,6.3,0,88,1091,12.4,9,zach-pascal-1
130,Chance Allen,Houston,American,12,56,815,14.6,6,0,0,,0,56,815,14.6,6,chance-allen-2
131,Gerald Everett,South Alabama,Sun Belt,12,49,717,14.6,4,0,0,,0,49,717,14.6,4,gerald-everett-1
132,Kendall Sanders,Arkansas State,Sun Belt,12,38,553,14.6,7,0,0,,0,38,553,14.6,7,kendall-sanders-1
133,Jeff Smith,Boston College,ACC,12,27,395,14.6,3,35,199,5.7,1,62,594,9.6,4,jeff-smith-10
134,Sergio Bailey,Eastern Michigan,MAC,13,60,868,14.5,7,3,22,7.3,0,63,890,14.1,7,sergio-bailey-1
135,Malachi Dupre,LSU,SEC,11,41,593,14.5,3,0,0,,0,41,593,14.5,3,malachi-dupre-1
136,Jauan Jennings,Tennessee,SEC,13,40,580,14.5,7,5,27,5.4,0,45,607,13.5,7,jauan-jennings-1
137,Joe Mixon,Oklahoma,Big 12,12,37,538,14.5,5,187,1274,6.8,10,224,1812,8.1,15,joe-mixon-1
138,Deshaunte Jones,Iowa State,Big 12,12,37,536,14.5,6,4,31,7.8,0,41,567,13.8,6,deshaunte-jones-1
139,Bra'Lon Cherry,North Carolina State,ACC,13,30,434,14.5,3,0,0,,0,30,434,14.5,3,bralon-cherry-1
140,John Mundt,Oregon,Pac-12,8,23,334,14.5,4,0,0,,0,23,334,14.5,4,john-mundt-1
141,Robert Davis,Georgia State,Sun Belt,12,67,968,14.4,5,0,0,,0,67,968,14.4,5,robert-davis-10
142,Bucky Hodges,Virginia Tech,ACC,14,48,691,14.4,7,9,42,4.7,0,57,733,12.9,7,bucky-hodges-1
143,Isaiah McKenzie,Georgia,SEC,13,44,633,14.4,7,19,134,7.1,2,63,767,12.2,9,isaiah-mckenzie-1
144,Cole Freytag,UTEP,CUSA,12,36,520,14.4,5,1,4,4,0,37,524,14.2,5,cole-freytag-1
145,Saquon Barkley,Penn State,Big Ten,14,28,402,14.4,4,272,1496,5.5,18,300,1898,6.3,22,saquon-barkley-1
146,B.J. Johnson,Georgia Southern,Sun Belt,11,42,600,14.3,3,0,0,,0,42,600,14.3,3,bj-johnson-3
147,Marcus McGill,Buffalo,MAC,11,40,573,14.3,0,0,0,,0,40,573,14.3,0,marcus-mcgill-1
148,Jehu Chesson,Michigan,Big Ten,13,35,500,14.3,2,12,63,5.3,1,47,563,12,3,jehu-chesson-1
149,John Ross,Washington,Pac-12,14,81,1150,14.2,17,8,102,12.8,1,89,1252,14.1,18,john-ross-1
150,Evan Engram,Ole Miss,SEC,11,65,926,14.2,8,0,0,,0,65,926,14.2,8,evan-engram-1
151,Daikiel Shorts,West Virginia,Big 12,13,63,894,14.2,5,0,0,,0,63,894,14.2,5,daikiel-shorts-1
152,Bruce Natson,Akron,MAC,12,59,837,14.2,10,4,6,1.5,0,63,843,13.4,10,bruce-natson-1
153,Cam Serigne,Wake Forest,ACC,12,30,426,14.2,3,0,0,,0,30,426,14.2,3,cam-serigne-1
154,A.J. Brown,Ole Miss,SEC,11,29,412,14.2,2,0,0,,0,29,412,14.2,2,aj-brown-3
155,Mike Gesicki,Penn State,Big Ten,14,48,679,14.1,5,0,0,,0,48,679,14.1,5,mike-gesicki-1
156,Darren Carrington,Oregon,Pac-12,12,43,606,14.1,5,1,6,6,0,44,612,13.9,5,darren-carrington-1
157,Montay Crockett,Georgia Southern,Sun Belt,11,24,339,14.1,1,2,25,12.5,0,26,364,14,1,montay-crockett-1
158,Justin Hunt,Marshall,CUSA,10,23,324,14.1,5,0,0,,0,23,324,14.1,5,justin-hunt-2
159,K.D. Cannon,Baylor,Big 12,12,87,1215,14,13,0,0,,0,87,1215,14,13,kd-cannon-1
160,Nacarius Fant,Western Kentucky,CUSA,9,29,407,14,2,6,26,4.3,0,35,433,12.4,2,nacarius-fant-1
161,Mike Williams,Clemson,ACC,15,98,1361,13.9,11,0,0,,0,98,1361,13.9,11,mike-williams-17
162,Austin Carr,Northwestern,Big Ten,13,90,1247,13.9,12,0,0,,0,90,1247,13.9,12,austin-carr-1
163,Thomas Owens,Florida International,CUSA,12,47,652,13.9,7,1,1,1,0,48,653,13.6,7,thomas-owens-1
164,Austin Proehl,North Carolina,ACC,13,43,597,13.9,3,0,0,,0,43,597,13.9,3,austin-proehl-1
165,Terren Encalade,Tulane,American,12,36,500,13.9,6,5,41,8.2,0,41,541,13.2,6,terren-encalade-1
166,Stantley Thomas,Florida International,CUSA,11,35,485,13.9,1,0,0,,0,35,485,13.9,1,stantley-thomas-1
167,Trent Sherfield,Vanderbilt,SEC,12,34,472,13.9,1,7,97,13.9,1,41,569,13.9,2,trent-sherfield-1
168,Andre Patton,Rutgers,Big Ten,10,33,460,13.9,5,0,0,,0,33,460,13.9,5,andre-patton-1
169,Deante Burton,Kansas State,Big 12,10,29,404,13.9,1,0,0,,0,29,404,13.9,1,deante-burton-1
170,Isaiah Ford,Virginia Tech,ACC,13,79,1094,13.8,7,6,33,5.5,0,85,1127,13.3,7,isaiah-ford-1
171,Jordan Westerkamp,Nebraska,Big Ten,10,38,526,13.8,5,3,18,6,1,41,544,13.3,6,jordan-westerkamp-1
172,Andrew Celis,Nevada,MWC,11,23,318,13.8,0,2,9,4.5,0,25,327,13.1,0,andrew-celis-1
173,Kalib Woods,Florida Atlantic,CUSA,12,68,934,13.7,1,0,0,,0,68,934,13.7,1,kalib-woods-1
174,Justin Hobbs,Tulsa,American,13,50,685,13.7,4,0,0,,0,50,685,13.7,4,justin-hobbs-1
175,Aaron Peck,Fresno State,MWC,11,46,630,13.7,3,0,0,,0,46,630,13.7,3,aaron-peck-1
176,Glenn Smith,Georgia State,Sun Belt,12,40,547,13.7,3,41,150,3.7,2,81,697,8.6,5,glenn-smith-2
177,Torii Hunter Jr,Notre Dame,Ind,8,38,521,13.7,3,0,0,,0,38,521,13.7,3,torii-hunter-jr-1
178,Donnie Corley,Michigan State,Big Ten,11,33,453,13.7,3,8,44,5.5,0,41,497,12.1,3,donnie-corley-1
179,Stanley Morgan Jr.,Nebraska,Big Ten,13,33,453,13.7,2,1,0,0,0,34,453,13.3,2,stanley-morgan-jr-1
180,Anthony Nash,Duke,ACC,6,29,398,13.7,2,0,0,,0,29,398,13.7,2,anthony-nash-1
181,Dorian Leonard,Texas,Big 12,10,29,397,13.7,3,0,-12,,0,29,385,13.3,3,dorian-leonard-1
182,Chad Hansen,California,Pac-12,10,92,1249,13.6,11,0,0,,0,92,1249,13.6,11,chad-hansen-1
183,Joshua Atkinson,Tulsa,American,13,78,1058,13.6,8,0,0,,0,78,1058,13.6,8,joshua-atkinson-1
184,Austin Duke,Charlotte,CUSA,12,59,803,13.6,4,11,40,3.6,0,70,843,12,4,austin-duke-1
185,Teo Redding,Bowling Green State,MAC,12,31,423,13.6,3,0,0,,0,31,423,13.6,3,teo-redding-1
186,Tommy Sweeney,Boston College,ACC,11,26,353,13.6,3,0,0,,0,26,353,13.6,3,tommy-sweeney-1
187,Mark Chapman,Central Michigan,MAC,12,44,592,13.5,4,6,71,11.8,0,50,663,13.3,4,mark-chapman-2
188,Keenan Barnes,Louisiana,Sun Belt,12,31,418,13.5,6,0,0,,0,31,418,13.5,6,keenan-barnes-1
189,Antonio Callaway,Florida,SEC,12,54,721,13.4,3,5,32,6.4,1,59,753,12.8,4,antonio-callaway-1
190,Cole Hikutini,Louisville,ACC,13,50,668,13.4,8,0,0,,0,50,668,13.4,8,cole-hikutini-1
191,Bryan Edwards,South Carolina,SEC,12,44,590,13.4,4,0,0,,0,44,590,13.4,4,bryan-edwards-1
192,Christian Blake,Northern Illinois,MAC,12,34,457,13.4,2,10,31,3.1,1,44,488,11.1,3,christian-blake-1
193,John Diarse,TCU,Big 12,13,33,442,13.4,3,0,0,,0,33,442,13.4,3,john-diarse-1
194,Dennis Andrews,Middle Tennessee State,CUSA,12,32,428,13.4,8,11,60,5.5,3,43,488,11.3,11,dennis-andrews-3
195,Trent Taylor,Louisiana Tech,CUSA,14,136,1803,13.3,12,0,0,,0,136,1803,13.3,12,trent-taylor-2
196,Kenny Golladay,Northern Illinois,MAC,12,87,1156,13.3,8,20,192,9.6,2,107,1348,12.6,10,kenny-golladay-1
197,Deebo Samuel,South Carolina,SEC,10,59,783,13.3,1,15,98,6.5,6,74,881,11.9,7,deebo-samuel-1
198,Tyler Conklin,Central Michigan,MAC,12,42,560,13.3,6,0,0,,0,42,560,13.3,6,tyler-conklin-1
199,River Cracraft,Washington State,Pac-12,10,53,701,13.2,5,0,0,,0,53,701,13.2,5,river-cracraft-1
200,O.J. Howard,Alabama,SEC,15,45,595,13.2,3,0,0,,0,45,595,13.2,3,oj-howard-1
201,Robert Wheelwright,Wisconsin,Big Ten,12,34,448,13.2,1,1,6,6,0,35,454,13,1,robert-wheelwright-1
202,Kyle Sweet,Washington State,Pac-12,13,27,357,13.2,3,1,5,5,0,28,362,12.9,3,kyle-sweet-1
203,Scott Miller,Bowling Green State,MAC,12,74,968,13.1,10,0,0,,0,74,968,13.1,10,scott-miller-3
204,JuJu Smith-Schuster,USC,Pac-12,13,70,914,13.1,10,5,27,5.4,0,75,941,12.5,10,juju-smith-1
205,Steven Dunbar,Houston,American,13,53,692,13.1,5,0,0,,0,53,692,13.1,5,steven-dunbar-1
206,Ron'Quavion Tarver,Utah State,MWC,12,46,602,13.1,3,0,0,,0,46,602,13.1,3,ronquavion-tarver-1
207,Drew Wolitarsky,Minnesota,Big Ten,13,66,860,13,5,3,6,2,0,69,866,12.6,5,drew-wolitarsky-1
208,Quincy Adeboyejo,Ole Miss,SEC,12,35,456,13,1,0,0,,0,35,456,13,1,quincy-adeboyejo-1
209,Tevaris McCormick,Troy,Sun Belt,10,35,456,13,5,2,2,1,0,37,458,12.4,5,tevaris-mccormick-1
210,Cortez Lewis,Wake Forest,ACC,11,32,415,13,1,0,0,,0,32,415,13,1,cortez-lewis-1
211,Jesus Wilson,Florida State,ACC,7,30,390,13,1,1,6,6,0,31,396,12.8,1,jesus-wilson-1
212,Dontre Wilson,Ohio State,Big Ten,11,27,352,13,5,16,78,4.9,1,43,430,10,6,dontre-wilson-1
213,Izaiah Lottie,New Mexico State,Sun Belt,10,26,339,13,2,0,0,,0,26,339,13,2,izaiah-lottie-1
214,Cam Phillips,Virginia Tech,ACC,14,76,983,12.9,5,30,140,4.7,0,106,1123,10.6,5,cam-phillips-1
215,Andy Isabella,Massachusetts,Ind,12,62,801,12.9,7,12,100,8.3,0,74,901,12.2,7,andy-isabella-1
216,Darren Andrews,UCLA,Pac-12,11,55,709,12.9,4,2,27,13.5,1,57,736,12.9,5,darren-andrews-1
217,Wyatt Demps,Nevada,MWC,12,53,686,12.9,9,0,0,,0,53,686,12.9,9,wyatt-demps-1
218,Nigel Kilby,Eastern Michigan,MAC,9,34,437,12.9,4,0,0,,0,34,437,12.9,4,nigel-kilby-1
219,Pharaoh Brown,Oregon,Pac-12,9,33,426,12.9,5,0,0,,0,33,426,12.9,5,pharaoh-brown-1
220,Jay MacIntyre,Colorado,Pac-12,13,32,412,12.9,1,4,12,3,0,36,424,11.8,1,jay-macintyre-1
221,Chaz Anderson,Boise State,MWC,11,30,386,12.9,0,2,-7,-3.5,0,32,379,11.8,0,chaz-anderson-1
222,Monty Madaris,Michigan State,Big Ten,10,24,310,12.9,1,1,12,12,0,25,322,12.9,1,monty-madaris-1
223,Hergy Mayala,Connecticut,American,9,23,296,12.9,0,0,0,,0,23,296,12.9,0,hergy-mayala-1
224,Ishmael Zamora,Baylor,Big 12,10,63,809,12.8,8,5,27,5.4,0,68,836,12.3,8,ishmael-zamora-1
225,Hayden Hurst,South Carolina,SEC,13,48,616,12.8,1,2,9,4.5,0,50,625,12.5,1,hayden-hurst-1
226,Jared Murphy,Miami (OH),MAC,13,43,552,12.8,5,2,-1,-0.5,0,45,551,12.2,5,jared-murphy-1
227,Jeremy McNichols,Boise State,MWC,13,37,474,12.8,4,314,1709,5.4,23,351,2183,6.2,27,jeremy-mcnichols-1
228,Cory Butler,Utah,Pac-12,8,29,372,12.8,0,20,163,8.2,1,49,535,10.9,1,cory-butler-1
229,John Niupalau,Eastern Michigan,MAC,11,28,359,12.8,4,0,0,,0,28,359,12.8,4,john-niupalau-1
230,Frederick Gammage,Arizona State,Pac-12,8,26,334,12.8,2,1,0,0,0,27,334,12.4,2,frederick-gammage-1
231,Ricky Seals-Jones,Texas A&M,SEC,9,26,333,12.8,1,0,0,,0,26,333,12.8,1,ricky-seals-jones-1
232,Fred Ross,Mississippi State,SEC,13,72,917,12.7,12,2,39,19.5,0,74,956,12.9,12,fred-ross-1
233,Tim White,Arizona State,Pac-12,12,56,713,12.7,2,5,-4,-0.8,0,61,709,11.6,2,tim-white-1
234,Thaddeous Thompson,North Texas,CUSA,12,43,545,12.7,2,0,0,,0,43,545,12.7,2,thaddeous-thompson-1
235,Michael Walker,Boston College,ACC,13,33,420,12.7,4,8,41,5.1,0,41,461,11.2,4,michael-walker-2
236,Jahad Thomas,Temple,American,12,33,418,12.7,6,207,953,4.6,13,240,1371,5.7,19,jahad-thomas-1
237,Kahlil Lewis,Cincinnati,American,11,48,605,12.6,5,9,107,11.9,0,57,712,12.5,5,kahlil-lewis-1
238,Noah Brown,Ohio State,Big Ten,12,32,402,12.6,7,0,0,,0,32,402,12.6,7,noah-brown-2
239,Justin Hardee,Illinois,Big Ten,10,25,314,12.6,0,1,12,12,0,26,326,12.5,0,justin-hardee-1
240,Doni Dowling,Virginia,ACC,11,50,626,12.5,4,0,0,,0,50,626,12.5,4,doni-dowling-1
241,Dimetrios Mason,Missouri,SEC,11,47,587,12.5,3,2,29,14.5,0,49,616,12.6,3,dimetrios-mason-1
242,Bryce Bobo,Colorado,Pac-12,12,44,548,12.5,2,0,0,,0,44,548,12.5,2,bryce-bobo-1
243,Nate Phillips,Arizona,Pac-12,11,33,414,12.5,2,0,0,,0,33,414,12.5,2,nate-phillips-1
244,Daniel Montiel,Memphis,American,11,27,338,12.5,3,0,0,,0,27,338,12.5,3,daniel-montiel-1
245,Corey Jones,Toledo,MAC,13,66,817,12.4,5,2,6,3,0,68,823,12.1,5,corey-jones-3
246,Michael Henry,Western Michigan,MAC,14,63,779,12.4,4,0,0,,0,63,779,12.4,4,michael-henry-1
247,James Proche,SMU,American,12,57,709,12.4,6,4,15,3.8,0,61,724,11.9,6,james-proche-1
248,Darreus Rogers,USC,Pac-12,13,56,696,12.4,4,0,0,,0,56,696,12.4,4,darreus-rogers-1
249,Armanti Foreman,Texas,Big 12,10,34,420,12.4,3,0,0,,0,34,420,12.4,3,armanti-foreman-1
250,Myles Campbell,Georgia Southern,Sun Belt,10,31,384,12.4,4,2,8,4,0,33,392,11.9,4,myles-campbell-1
251,Isaac Nauta,Georgia,SEC,11,29,361,12.4,3,0,0,,0,29,361,12.4,3,isaac-nauta-1
252,Brady Jones,UTSA,CUSA,11,26,322,12.4,3,1,-1,-1,0,27,321,11.9,3,brady-jones-2
253,Bernard Davis,Massachusetts,Ind,10,24,298,12.4,2,0,0,,0,24,298,12.4,2,bernard-davis-2
254,Rodney Adams,South Florida,American,13,67,822,12.3,5,23,231,10,5,90,1053,11.7,10,rodney-adams-1
255,Deondre Douglas,Troy,Sun Belt,13,60,740,12.3,6,1,1,1,0,61,741,12.1,6,deondre-douglas-1
256,John Ursua,Hawaii,MWC,14,53,652,12.3,3,4,8,2,1,57,660,11.6,4,john-ursua-1
257,Troy Fumagalli,Wisconsin,Big Ten,13,47,580,12.3,2,0,0,,0,47,580,12.3,2,troy-fumagalli-2
258,Riley McCarron,Iowa,Big Ten,12,42,517,12.3,4,2,-3,-1.5,0,44,514,11.7,4,riley-mccarron-1
259,Jawuan Harris,Rutgers,Big Ten,11,39,481,12.3,3,7,-6,-0.9,0,46,475,10.3,3,jawuan-harris-1
260,Jaleel Scott,New Mexico State,Sun Belt,11,23,283,12.3,5,0,0,,0,23,283,12.3,5,jaleel-scott-1
261,Al-Damion Riles,Louisiana,Sun Belt,13,60,729,12.2,2,10,46,4.6,0,70,775,11.1,2,al-damion-riles-1
262,Nyheim Hines,North Carolina State,ACC,12,43,525,12.2,0,13,44,3.4,0,56,569,10.2,0,nyheim-hines-1
263,Ronnie Moore,Bowling Green State,MAC,12,42,513,12.2,1,8,21,2.6,2,50,534,10.7,3,ronnie-moore-3
264,Workpeh Kofa,Charlotte,CUSA,12,27,329,12.2,5,0,0,,0,27,329,12.2,5,workpeh-kofa-1
265,Jordan Veasy,California,Pac-12,10,25,306,12.2,3,0,0,,0,25,306,12.2,3,jordan-veasy-1
266,C.J Sanders,Notre Dame,Ind,12,24,293,12.2,2,4,22,5.5,0,28,315,11.3,2,cj-sanders-1
267,Ka'Raun White,West Virginia,Big 12,11,48,583,12.1,5,0,0,,0,48,583,12.1,5,karaun-white-1
268,Geno Lewis,Oklahoma,Big 12,12,32,388,12.1,2,0,0,,0,32,388,12.1,2,geno-lewis-1
269,Stacy Coley,Miami (FL),ACC,13,63,754,12,9,0,0,,0,63,754,12,9,stacy-coley-1
270,Jonnu Smith,Florida International,CUSA,11,42,506,12,4,1,5,5,0,43,511,11.9,4,jonnu-smith-1
271,Hayden Plinke,UTEP,CUSA,12,38,456,12,8,0,0,,0,38,456,12,8,hayden-plinke-2
272,Jacorey Warrick,Texas,Big 12,11,30,360,12,3,0,0,,0,30,360,12,3,jacorey-warrick-1
273,Justin Rankin,Kent State,MAC,11,28,335,12,1,108,511,4.7,3,136,846,6.2,4,justin-rankin-1
274,Steven Sims Jr.,Kansas,Big 12,12,72,859,11.9,7,2,-9,-4.5,0,74,850,11.5,7,steven-sims-jr-1
275,Jake Butt,Michigan,Big Ten,12,46,546,11.9,4,0,0,,0,46,546,11.9,4,jake-butt-1
276,Bilal Marshall,Purdue,Big Ten,12,40,477,11.9,3,9,14,1.6,0,49,491,10,3,bilal-marshall-1
277,Trenton Irwin,Stanford,Pac-12,13,37,442,11.9,1,0,0,,0,37,442,11.9,1,trenton-irwin-1
278,T.L. Ford,Charlotte,CUSA,12,36,430,11.9,4,0,0,,0,36,430,11.9,4,tl-ford-1
279,Blake Lynch,Baylor,Big 12,11,34,404,11.9,3,12,80,6.7,0,46,484,10.5,3,blake-lynch-1
280,Robert Lewis,Washington State,Pac-12,12,33,394,11.9,3,1,1,1,0,34,395,11.6,3,robert-lewis-7
281,Christopher Herndon IV,Miami (FL),ACC,13,28,334,11.9,2,0,0,,0,28,334,11.9,2,christopher-herndon-iv-1
282,Tyrone Williams,South Alabama,Sun Belt,11,28,333,11.9,1,0,0,,0,28,333,11.9,1,tyrone-williams-3
283,Patrick Smith,Middle Tennessee State,CUSA,11,28,332,11.9,4,0,0,,0,28,332,11.9,4,patrick-smith-1
284,Noel Thomas,Connecticut,American,12,100,1179,11.8,3,13,60,4.6,0,113,1239,11,3,noel-thomas-1
285,Laquvionte Gonzalez,Kansas,Big 12,12,62,729,11.8,3,3,-9,-3,0,65,720,11.1,3,laquvionte-gonzalez-1
286,Tim Crawley,San Jose State,MWC,12,55,648,11.8,3,17,91,5.4,2,72,739,10.3,5,tim-crawley-1
287,Victor Bolden,Oregon State,Pac-12,12,46,542,11.8,2,28,329,11.8,2,74,871,11.8,4,victor-bolden-1
288,Michael Roberts,Toledo,MAC,13,45,533,11.8,16,0,0,,0,45,533,11.8,16,michael-roberts-3
289,Tabari Hines,Wake Forest,ACC,12,38,447,11.8,3,3,-4,-1.3,0,41,443,10.8,3,tabari-hines-1
290,Korey Robertson,Southern Mississippi,CUSA,13,37,437,11.8,3,1,-3,-3,0,38,434,11.4,3,korey-robertson-1
291,Turner Smiley,North Texas,CUSA,10,33,389,11.8,2,0,0,,0,33,389,11.8,2,turner-smiley-1
292,Gregory Hogan,New Mexico State,Sun Belt,9,32,377,11.8,3,0,0,,0,32,377,11.8,3,gregory-hogan-1
293,Kalija Lipscomb,Vanderbilt,SEC,11,27,319,11.8,2,3,5,1.7,0,30,324,10.8,2,kalija-lipscomb-1
294,Sean Culkin,Missouri,SEC,9,24,282,11.8,0,0,0,,0,24,282,11.8,0,sean-culkin-1
295,Curtis Samuel,Ohio State,Big Ten,13,74,865,11.7,7,97,771,7.9,8,171,1636,9.6,15,curtis-samuel-1
296,KeeSean Johnson,Fresno State,MWC,12,66,773,11.7,6,3,13,4.3,0,69,786,11.4,6,keesean-johnson-1
297,Rayshad Lewis,Utah State,MWC,12,40,469,11.7,2,10,110,11,1,50,579,11.6,3,rayshad-lewis-1
298,Domonique Young,Purdue,Big Ten,5,29,338,11.7,1,0,0,,0,29,338,11.7,1,domonique-young-1
299,Eddie Sinegal,UTEP,CUSA,9,29,338,11.7,0,2,44,22,0,31,382,12.3,0,eddie-sinegal-1
300,Ryan Switzer,North Carolina,ACC,13,96,1112,11.6,6,3,14,4.7,0,99,1126,11.4,6,ryan-switzer-1
301,Dylan Cantrell,Texas Tech,Big 12,10,58,675,11.6,8,0,0,,0,58,675,11.6,8,dylan-cantrell-1
302,Steve Ishmael,Syracuse,ACC,10,48,559,11.6,1,0,0,,0,48,559,11.6,1,steve-ishmael-1
303,Teldrick Morgan,Maryland,Big Ten,13,43,497,11.6,4,6,34,5.7,0,49,531,10.8,4,teldrick-morgan-1
304,Seth Collins,Oregon State,Pac-12,10,36,418,11.6,1,15,30,2,0,51,448,8.8,1,seth-collins-1
305,Kermit Whitfield,Florida State,ACC,13,34,395,11.6,1,8,79,9.9,1,42,474,11.3,2,kermit-whitfield-1
306,Callen Hightower,Idaho,Sun Belt,10,33,383,11.6,3,4,7,1.8,0,37,390,10.5,3,callen-hightower-1
307,Jaquil Capel,Appalachian State,Sun Belt,12,25,290,11.6,1,0,0,,0,25,290,11.6,1,jaquil-capel-1
308,Adam Breneman,Massachusetts,Ind,12,70,808,11.5,8,0,0,,0,70,808,11.5,8,adam-breneman-1
309,Olamide Zaccheaus,Virginia,ACC,12,51,584,11.5,7,3,24,8,0,54,608,11.3,7,olamide-zaccheaus-1
310,Kylen Granson,Rice,CUSA,7,33,381,11.5,2,4,41,10.3,0,37,422,11.4,2,kylen-granson-1
311,Jeremy Sprinkle,Arkansas,SEC,12,33,380,11.5,4,0,0,,0,33,380,11.5,4,jeremy-sprinkle-1
312,Michael Rector,Stanford,Pac-12,12,32,367,11.5,3,5,71,14.2,1,37,438,11.8,4,michael-rector-1
313,Ryan Smith,Miami (OH),MAC,11,31,356,11.5,5,0,0,,0,31,356,11.5,5,ryan-smith-9
314,Jonah Trinnaman,Brigham Young,Ind,10,28,321,11.5,1,0,0,,0,28,321,11.5,1,jonah-trinnaman-1
315,Linell Bonner,Houston,American,12,98,1118,11.4,3,5,6,1.2,0,103,1124,10.9,3,linell-bonner-1
316,Kevonn Mabon,Ball State,MAC,12,85,972,11.4,3,12,64,5.3,1,97,1036,10.7,4,kevonn-mabon-1
317,Devin Ross,Colorado,Pac-12,14,69,787,11.4,5,3,10,3.3,0,72,797,11.1,5,devin-ross-2
318,Drew Morgan,Arkansas,SEC,13,65,739,11.4,3,4,8,2,0,69,747,10.8,3,drew-morgan-1
319,Tavares Martin Jr.,Washington State,Pac-12,13,64,728,11.4,7,0,0,,0,64,728,11.4,7,tavares-martin-jr-1
320,N'Keal Harry,Arizona State,Pac-12,12,58,659,11.4,5,3,69,23,2,61,728,11.9,7,nkeal-harry-1
321,Trent Cowan,Idaho,Sun Belt,13,48,547,11.4,6,0,0,,0,48,547,11.4,6,trent-cowan-1
322,Thurman Morbley,Texas State,Sun Belt,10,35,400,11.4,2,5,36,7.2,0,40,436,10.9,2,thurman-morbley-1
323,Andrew Scanlan,Northwestern,Big Ten,13,29,331,11.4,0,0,0,,0,29,331,11.4,0,andrew-scanlan-1
324,Gabe Schrade,Texas State,Sun Belt,8,25,286,11.4,2,0,0,,0,25,286,11.4,2,gabe-schrade-1
325,Jordan Reid,Ohio,MAC,14,58,655,11.3,6,0,0,,0,58,655,11.3,6,jordan-reid-1
326,Hunter Renfrow,Clemson,ACC,11,44,495,11.3,6,0,0,,0,44,495,11.3,6,hunter-renfrow-1
327,Deon-Tay McManus,Marshall,CUSA,10,40,453,11.3,3,0,0,,0,40,453,11.3,3,deon-tay-mcmanus-1
328,Keith Rucker,Georgia State,Sun Belt,10,32,362,11.3,2,0,0,,0,32,362,11.3,2,keith-rucker-1
329,Collin Johnson,Texas,Big 12,9,28,315,11.3,3,0,0,,0,28,315,11.3,3,collin-johnson-2
330,Christian Kirk,Texas A&M,SEC,13,83,928,11.2,9,8,35,4.4,0,91,963,10.6,9,christian-kirk-1
331,C.J. Duncan,Vanderbilt,SEC,12,44,494,11.2,0,0,0,,0,44,494,11.2,0,cj-duncan-1
332,Antoine Porter,Eastern Michigan,MAC,11,44,491,11.2,4,1,0,0,0,45,491,10.9,4,antoine-porter-1
333,Flynn Nagel,Northwestern,Big Ten,11,40,447,11.2,2,0,0,,0,40,447,11.2,2,flynn-nagel-1
334,Henry Bussey,Florida Atlantic,CUSA,10,24,269,11.2,2,3,17,5.7,0,27,286,10.6,2,henry-bussey-1
335,Zay Jones,East Carolina,American,12,158,1746,11.1,8,4,24,6,0,162,1770,10.9,8,isaiah-jones-2
336,Jalen McCleskey,Oklahoma State,Big 12,13,73,812,11.1,7,3,9,3,0,76,821,10.8,7,jalen-mccleskey-1
337,Ty Lee,Middle Tennessee State,CUSA,13,63,699,11.1,9,6,107,17.8,1,69,806,11.7,10,ty-lee-1
338,Mitchell Paige,Indiana,Big Ten,13,58,646,11.1,4,5,36,7.2,1,63,682,10.8,5,mitchell-paige-1
339,Deontay Burnett,USC,Pac-12,12,56,622,11.1,7,3,31,10.3,0,59,653,11.1,7,deontay-burnett-1
340,Van Jefferson,Ole Miss,SEC,12,49,543,11.1,3,5,40,8,0,54,583,10.8,3,van-jefferson-1
341,Darnell Mooney,Tulane,American,9,24,267,11.1,2,4,22,5.5,0,28,289,10.3,2,darnell-mooney-1
342,Jerrod Heard,Texas,Big 12,9,24,266,11.1,3,1,-12,-12,0,25,254,10.2,3,jerrod-heard-1
343,Mason Schreck,Buffalo,MAC,12,59,651,11,4,0,0,,0,59,651,11,4,mason-schreck-1
344,Nick Kurtz,Brigham Young,Ind,12,49,541,11,2,0,0,,0,49,541,11,2,nick-kurtz-1
345,Andrew Rodriguez,Utah State,MWC,12,26,286,11,1,0,0,,0,26,286,11,1,andrew-rodriguez-2
346,Quadree Henderson,Pitt,ACC,13,26,286,11,1,60,631,10.5,5,86,917,10.7,6,quadree-henderson-1
347,D.J. Thompson,Southern Mississippi,CUSA,10,47,510,10.9,6,1,0,0,0,48,510,10.6,6,dj-thompson-1
348,Chris Taylor,Duke,ACC,10,29,315,10.9,1,0,0,,0,29,315,10.9,1,chris-taylor-4
349,Arkeel Newsome,Connecticut,American,12,25,273,10.9,2,147,715,4.9,5,172,988,5.7,7,arkeel-newsome-1
350,Brisly Estime,Syracuse,ACC,12,48,518,10.8,3,4,22,5.5,0,52,540,10.4,3,brisly-estime-1
351,Jake Oliver,Texas,Big 12,12,33,358,10.8,0,0,0,,0,33,358,10.8,0,jake-oliver-1
352,Anthony Wales,Western Kentucky,CUSA,13,30,323,10.8,2,237,1621,6.8,27,267,1944,7.3,29,anthony-wales-1
353,Jacob Sannon,Idaho,Sun Belt,10,28,303,10.8,2,0,0,,0,28,303,10.8,2,jacob-sannon-1
354,Calvin Ridley,Alabama,SEC,15,72,769,10.7,7,5,21,4.2,1,77,790,10.3,8,calvin-ridley-1
355,Cameron Batson,Texas Tech,Big 12,12,60,644,10.7,8,2,4,2,0,62,648,10.5,8,cameron-batson-1
356,Charles Nelson,Oregon,Pac-12,12,52,554,10.7,5,4,37,9.3,1,56,591,10.6,6,charles-nelson-2
357,Kalen Ballage,Arizona State,Pac-12,12,44,469,10.7,1,126,536,4.3,14,170,1005,5.9,15,kalen-ballage-1
358,Ito Smith,Southern Mississippi,CUSA,13,43,459,10.7,2,265,1459,5.5,17,308,1918,6.2,19,ito-smith-1
359,Levern Jacobs,Maryland,Big Ten,13,41,439,10.7,2,1,10,10,0,42,449,10.7,2,levern-jacobs-1
360,Todd Boyd,Georgia State,Sun Belt,9,33,352,10.7,1,2,7,3.5,0,35,359,10.3,1,todd-boyd-1
361,T.J. Rahming,Duke,ACC,11,70,742,10.6,1,1,-1,-1,0,71,741,10.4,1,tj-rahming-1
362,Xavier Castille,SMU,American,11,40,423,10.6,1,0,0,,0,40,423,10.6,1,xavier-castille-1
363,Ryan Yurachek,Marshall,CUSA,11,28,298,10.6,5,1,9,9,0,29,307,10.6,5,ryan-yurachek-1
364,Shane Wimann,Northern Illinois,MAC,12,24,254,10.6,6,0,0,,0,24,254,10.6,6,shane-wimann-1
365,Trever Ryen,Iowa State,Big 12,11,37,388,10.5,2,1,8,8,0,38,396,10.4,2,trever-ryen-1
366,Taylor Oldham,UCF,American,11,35,366,10.5,1,0,0,,0,35,366,10.5,1,taylor-oldham-1
367,D'Ernest Johnson,South Florida,American,13,28,293,10.5,5,111,543,4.9,8,139,836,6,13,dernest-johnson-1
368,Vic Wharton,California,Pac-12,10,28,293,10.5,1,0,0,,0,28,293,10.5,1,vic-wharton-1
369,Aregeros Turner,Northern Illinois,MAC,12,40,415,10.4,3,25,167,6.7,2,65,582,9,5,aregeros-turner-1
370,Terry Godwin,Georgia,SEC,13,38,397,10.4,0,4,14,3.5,0,42,411,9.8,0,terry-godwin-1
371,Jerico Richardson,Nevada,MWC,10,26,271,10.4,1,0,0,,0,26,271,10.4,1,jerico-richardson-1
372,Emanuel Thompson,Troy,Sun Belt,13,80,820,10.3,6,0,0,,0,80,820,10.3,6,emanuel-thompson-1
373,Jaylen Samuels,North Carolina State,ACC,13,55,565,10.3,7,33,189,5.7,6,88,754,8.6,13,jaylen-samuels-1
374,Alfonso Onunwor,Idaho,Sun Belt,13,39,403,10.3,1,0,0,,0,39,403,10.3,1,alfonso-onunwor-1
375,James Butler,Nevada,MWC,12,37,381,10.3,3,260,1336,5.1,12,297,1717,5.8,15,james-butler-4
376,Corey Lacanaria,Ball State,MAC,9,33,341,10.3,2,0,0,,0,33,341,10.3,2,corey-lacanaria-1
377,Tony Pollard,Memphis,American,13,29,298,10.3,2,31,159,5.1,1,60,457,7.6,3,tony-pollard-1
378,Moroni Laulu-Pututau,Brigham Young,Ind,10,27,277,10.3,2,0,0,,0,27,277,10.3,2,moroni-laulu-pututau-1
379,Josh Knight,Marshall,CUSA,11,62,631,10.2,5,0,0,,0,62,631,10.2,5,josh-knight-1
380,Jamal Morrow,Washington State,Pac-12,13,48,488,10.2,5,90,575,6.4,5,138,1063,7.7,10,jamal-morrow-1
381,Josiah Price,Michigan State,Big Ten,11,38,387,10.2,5,0,0,,0,38,387,10.2,5,josiah-price-1
382,Keenen Johnson,Tulsa,American,8,30,305,10.2,1,2,10,5,0,32,315,9.8,1,keenen-johnson-1
383,Zach Grant,Illinois,Big Ten,12,26,265,10.2,1,0,0,,0,26,265,10.2,1,zach-grant-1
384,Colby Pearson,Brigham Young,Ind,13,38,384,10.1,4,1,3,3,0,39,387,9.9,4,colby-pearson-1
385,Kenny Buyers,North Texas,CUSA,12,32,324,10.1,1,0,0,,0,32,324,10.1,1,kenny-buyers-1
386,Gabe Marks,Washington State,Pac-12,13,89,894,10,13,2,6,3,0,91,900,9.9,13,gabe-marks-1
387,Hasaan Henderson,Nevada,MWC,10,30,301,10,1,0,0,,0,30,301,10,1,hasaan-henderson-1
388,Travin Dural,LSU,SEC,9,28,280,10,1,1,-2,-2,0,29,278,9.6,1,travin-dural-1
389,Damon Hazelton Jr,Ball State,MAC,10,51,505,9.9,4,0,0,,0,51,505,9.9,4,damon-hazelton-jr-1
390,Melquise Stovall,California,Pac-12,10,42,415,9.9,3,3,10,3.3,0,45,425,9.4,3,melquise-stovall-1
391,Devin Lauderdale,Texas Tech,Big 12,9,31,307,9.9,2,0,0,,0,31,307,9.9,2,devin-lauderdale-1
392,Kareem Hunt,Toledo,MAC,13,41,403,9.8,1,262,1475,5.6,10,303,1878,6.2,11,kareem-hunt-1
393,Alvin Kamara,Tennessee,SEC,11,40,392,9.8,4,103,596,5.8,9,143,988,6.9,13,alvin-kamara-1
394,Cole Herdman,Purdue,Big Ten,12,35,344,9.8,3,0,0,,0,35,344,9.8,3,cole-herdman-1
395,Mitchell Juergens,Brigham Young,Ind,11,34,333,9.8,2,0,0,,0,34,333,9.8,2,mitchell-juergens-1
396,Dylan Collie,Hawaii,MWC,12,33,322,9.8,4,1,9,9,0,34,331,9.7,4,dylan-collie-1
397,KaVontae Turpin,TCU,Big 12,8,30,295,9.8,1,9,84,9.3,0,39,379,9.7,1,kavontae-turpin-1
398,Quay Johnson,East Carolina,American,12,58,563,9.7,3,4,9,2.3,0,62,572,9.2,3,quay-johnson-1
399,Keeon Johnson,Virginia,ACC,12,49,476,9.7,3,0,0,,0,49,476,9.7,3,keeon-johnson-2
400,Dominique Heath,Kansas State,Big 12,13,45,438,9.7,3,2,54,27,1,47,492,10.5,4,dominique-heath-1
401,Connor Cella,Rice,CUSA,12,31,302,9.7,1,0,0,,0,31,302,9.7,1,connor-cella-1
402,I'Tavius Mathers,Middle Tennessee State,CUSA,13,66,633,9.6,3,232,1561,6.7,17,298,2194,7.4,20,itavius-mathers-1
403,Ray-Ray McCloud,Clemson,ACC,13,49,472,9.6,2,5,28,5.6,0,54,500,9.3,2,ray-ray-mccloud-1
404,Marcus Green,Louisiana-Monroe,Sun Belt,12,36,344,9.6,4,14,119,8.5,0,50,463,9.3,4,marcus-green-6
405,Jovon Durante,West Virginia,Big 12,12,35,331,9.5,2,3,15,5,0,38,346,9.1,2,jovon-durante-1
406,Shakiem Barbel,Kansas,Big 12,11,34,323,9.5,0,0,0,,0,34,323,9.5,0,shakiem-barbel-1
407,Bug Rivera,California,Pac-12,11,41,386,9.4,3,2,-4,-2,0,43,382,8.9,3,bug-rivera-1
408,Garrett Dickerson,Northwestern,Big Ten,12,34,318,9.4,5,0,0,,0,34,318,9.4,5,garrett-dickerson-1
409,Phillip Lindsay,Colorado,Pac-12,14,53,493,9.3,1,244,1252,5.1,16,297,1745,5.9,17,phillip-lindsay-1
410,Eddie Daugherty,Eastern Michigan,MAC,11,31,289,9.3,0,2,12,6,0,33,301,9.1,0,eddie-daugherty-1
411,Emanuel Byrd,Marshall,CUSA,11,26,242,9.3,3,1,-3,-3,0,27,239,8.9,3,emanuel-byrd-1
412,Wyatt Houston,Utah State,MWC,12,36,331,9.2,2,0,0,,0,36,331,9.2,2,wyatt-houston-1
413,Desmon White,TCU,Big 12,13,30,276,9.2,1,0,0,,0,30,276,9.2,1,desmon-white-1
414,Ervin Phillips,Syracuse,ACC,12,90,822,9.1,6,6,18,3,1,96,840,8.8,7,ervin-phillips-1
415,Nate Cole,Cincinnati,American,12,57,518,9.1,4,0,0,,0,57,518,9.1,4,nate-cole-2
416,Cameron Posey,Purdue,Big Ten,11,39,356,9.1,3,3,10,3.3,0,42,366,8.7,3,cameron-posey-1
417,Zach Wright,Rice,CUSA,9,38,346,9.1,1,0,0,,0,38,346,9.1,1,zach-wright-1
418,Tee Goree,North Texas,CUSA,8,36,328,9.1,2,0,0,,0,36,328,9.1,2,tee-goree-1
419,Ajalen Holley,Louisiana-Monroe,Sun Belt,12,34,310,9.1,1,3,7,2.3,0,37,317,8.6,1,ajalen-holley-1
420,DeAndre Goolsby,Florida,SEC,11,38,342,9,3,0,0,,0,38,342,9,3,deandre-goolsby-1
421,Erich Schneider,Duke,ACC,11,30,269,9,3,0,0,,0,30,269,9,3,erich-schneider-1
422,Raekwon James,Kent State,MAC,11,25,225,9,0,8,59,7.4,0,33,284,8.6,0,raekwon-james-1
423,Kyle Hicks,TCU,Big 12,13,47,417,8.9,2,203,1042,5.1,12,250,1459,5.8,14,kyle-hicks-1
424,Johnathan Lloyd,Duke,ACC,11,34,301,8.9,3,1,3,3,0,35,304,8.7,3,johnathan-lloyd-1
425,Mark Walton,Miami (FL),ACC,13,27,240,8.9,1,209,1117,5.3,14,236,1357,5.8,15,mark-walton-1
426,Akrum Wadley,Iowa,Big Ten,13,36,315,8.8,3,168,1081,6.4,10,204,1396,6.8,13,akrum-wadley-1
427,Brandon Powell,Florida,SEC,13,45,387,8.6,2,7,6,0.9,0,52,393,7.6,2,brandon-powell-1
428,Donnel Pumphrey,San Diego State,MWC,14,27,231,8.6,0,349,2133,6.1,17,376,2364,6.3,17,donnel-pumphrey-1
429,Tyler Watts,Texas State,Sun Belt,12,43,364,8.5,1,3,0,0,0,46,364,7.9,1,tyler-watts-2
430,Matt Dayes,North Carolina State,ACC,13,32,271,8.5,0,249,1166,4.7,10,281,1437,5.1,10,matt-dayes-1
431,Jeffery Wilson,North Texas,CUSA,11,29,247,8.5,1,169,936,5.5,14,198,1183,6,15,jeffery-wilson-2
432,Christian McCaffrey,Stanford,Pac-12,11,37,310,8.4,3,253,1603,6.3,13,290,1913,6.6,16,christian-mccaffrey-1
433,T.J. Logan,North Carolina,ACC,13,29,244,8.4,3,120,650,5.4,7,149,894,6,10,tj-logan-1
434,Aaron Jones,UTEP,CUSA,12,28,233,8.3,3,229,1773,7.7,17,257,2006,7.8,20,aaron-jones-6
435,Elijah McGuire,Louisiana,Sun Belt,13,29,238,8.2,2,232,1127,4.9,7,261,1365,5.2,9,elijah-mcguire-1
436,Artavis Scott,Clemson,ACC,15,76,614,8.1,5,6,11,1.8,0,82,625,7.6,5,artavis-scott-1
437,Jarred Craft,Louisiana Tech,CUSA,14,42,340,8.1,4,191,1074,5.6,9,233,1414,6.1,13,jarred-craft-1
438,Marlon Mack,South Florida,American,12,28,227,8.1,0,174,1187,6.8,15,202,1414,7,15,marlon-mack-1
439,OJ Clark,New Mexico State,Sun Belt,11,43,338,7.9,1,0,0,,0,43,338,7.9,1,oj-clark-1
440,D'Eriq King,Houston,American,9,29,228,7.9,1,15,56,3.7,0,44,284,6.5,1,deriq-king-1
441,Taquan Mizzell,Virginia,ACC,12,52,404,7.8,2,187,940,5,5,239,1344,5.6,7,taquan-mizzell-1
442,Stedman Mayberry,Texas State,Sun Belt,12,41,321,7.8,0,157,593,3.8,5,198,914,4.6,5,stedman-mayberry-1
443,Ryan Davis,Auburn,SEC,10,25,194,7.8,1,3,5,1.7,0,28,199,7.1,1,ryan-davis-5
444,Jordan Chunn,Troy,Sun Belt,13,30,228,7.6,0,279,1288,4.6,16,309,1516,4.9,16,jordan-chunn-1
445,Larry Rose III,New Mexico State,Sun Belt,9,25,180,7.2,0,159,865,5.4,4,184,1045,5.7,4,larry-rose-iii-1
446,James Williams,Washington State,Pac-12,13,48,342,7.1,1,102,585,5.7,6,150,927,6.2,7,james-williams-13
447,Anthony Scott,East Carolina,American,8,23,164,7.1,3,79,384,4.9,2,102,548,5.4,5,anthony-scott-2
448,Isaiah Johnson-Mack,Washington State,Pac-12,11,35,246,7,1,0,0,,0,35,246,7,1,isaiah-johnson-mack-1
449,Willy Ivery,North Texas,CUSA,11,25,173,6.9,2,90,489,5.4,6,115,662,5.8,8,willy-ivery-1
450,Markell Jones,Purdue,Big Ten,11,32,215,6.7,0,153,616,4,4,185,831,4.5,4,markell-jones-1
451,Devon Spalding,Central Michigan,MAC,11,31,204,6.6,1,138,758,5.5,6,169,962,5.7,7,devon-spalding-1
452,Duke Catalon,Houston,American,9,44,281,6.4,3,145,528,3.6,4,189,809,4.3,7,duke-catalon-1
453,Alex Gardner,Florida International,CUSA,12,30,191,6.4,0,181,930,5.1,6,211,1121,5.3,6,alex-gardner-2
454,Justin Jackson,Northwestern,Big Ten,13,35,219,6.3,0,298,1524,5.1,15,333,1743,5.2,15,justin-jackson-5
455,Gerard Wicks,Washington State,Pac-12,13,29,184,6.3,1,88,475,5.4,11,117,659,5.6,12,gerard-wicks-1
456,Devin Singletary,Florida Atlantic,CUSA,12,26,163,6.3,0,152,1021,6.7,12,178,1184,6.7,12,devin-singletary-1
457,Royce Freeman,Oregon,Pac-12,11,23,144,6.3,1,168,945,5.6,9,191,1089,5.7,10,royce-freeman-1
458,Tion Green,Cincinnati,American,12,29,167,5.8,0,159,743,4.7,2,188,910,4.8,2,tion-green-1
459,Marquis Young,Massachusetts,Ind,12,26,147,5.7,0,197,898,4.6,4,223,1045,4.7,4,marquis-young-1
460,Elijah Hood,North Carolina,ACC,11,25,142,5.7,0,145,858,5.9,8,170,1000,5.9,8,elijah-hood-1
461,Devine Redding,Indiana,Big Ten,13,27,146,5.4,2,253,1122,4.4,7,280,1268,4.5,9,devine-redding-1
462,Darian Green,Ball State,MAC,8,24,124,5.2,0,57,311,5.5,1,81,435,5.4,1,darian-green-1