Rk,Player,School,Conf,G,Rec,Yds,Avg,TD,Att,Yds,Avg,TD,Plays,Yds,Avg,TD,-9999
1,Aaron Cephus,Rice,CUSA,10,25,622,24.9,5,0,0,,0,25,622,24.9,5,aaron-cephus-1
2,Emanuel Hall,Missouri,SEC,10,33,817,24.8,8,0,0,,0,33,817,24.8,8,emanuel-hall-1
3,Byron Pringle,Kansas State,Big 12,12,30,724,24.1,6,1,15,15,0,31,739,23.8,6,byron-pringle-1
4,Damion Ratley,Texas A&M,SEC,12,30,694,23.1,6,0,0,,0,30,694,23.1,6,damion-ratley-1
5,Darius Slayton,Auburn,SEC,11,29,643,22.2,5,0,0,,0,29,643,22.2,5,darius-slayton-1
6,D.J. Chark,LSU,SEC,13,40,874,21.9,3,12,63,5.3,1,52,937,18,4,dj-chark-1
7,Ricky Jeune,Georgia Tech,ACC,11,25,545,21.8,6,1,30,30,0,26,575,22.1,6,ricky-jeune-1
8,Arkeel Newsome,Connecticut,American,10,25,541,21.6,2,67,261,3.9,3,92,802,8.7,5,arkeel-newsome-1
9,Kwadarrius Smith,Akron,MAC,11,34,726,21.4,7,0,0,,0,34,726,21.4,7,kwadarrius-smith-1
10,James Washington,Oklahoma State,Big 12,13,74,1549,20.9,13,3,12,4,1,77,1561,20.3,14,james-washington-5
11,Jamire Jordan,Fresno State,MWC,13,27,562,20.8,3,1,-7,-7,0,28,555,19.8,3,jamire-jordan-1
12,Chris Jones,Coastal Carolina,Sun Belt,10,26,536,20.6,4,4,45,11.3,0,30,581,19.4,4,chris-jones-17
13,James Proche,SMU,American,12,40,816,20.4,6,0,0,,0,40,816,20.4,6,james-proche-1
14,Andre Levrone,Virginia,ACC,12,34,689,20.3,7,0,0,,0,34,689,20.3,7,andre-levrone-1
15,Tre'Quan Smith,UCF,American,13,59,1171,19.8,13,5,23,4.6,1,64,1194,18.7,14,trequan-smith-1
16,James Gardner,Miami (OH),MAC,11,47,927,19.7,11,0,0,,0,47,927,19.7,11,james-gardner-1
17,Marcell Ateman,Oklahoma State,Big 12,13,59,1156,19.6,8,0,0,,0,59,1156,19.6,8,marcell-ateman-1
18,Tyler Johnson,Minnesota,Big Ten,10,35,677,19.3,7,0,0,,0,35,677,19.3,7,tyler-johnson-6
19,Marquise Brown,Oklahoma,Big 12,13,57,1095,19.2,7,1,0,0,0,58,1095,18.9,7,marquise-brown-1
20,Cody Thompson,Toledo,MAC,5,28,537,19.2,4,0,0,,0,28,537,19.2,4,cody-thompson-1
21,Tyree McCants,South Florida,American,11,36,686,19.1,7,1,30,30,0,37,716,19.4,7,tyree-mccants-1
22,Marcus Simms,West Virginia,Big 12,12,35,663,18.9,5,1,-1,-1,0,36,662,18.4,5,marcus-simms-1
23,Datrin Guyton,Bowling Green State,MAC,11,31,585,18.9,2,0,0,,0,31,585,18.9,2,datrin-guyton-1
24,T.J. Vasher,Texas Tech,Big 12,9,29,545,18.8,6,0,0,,0,29,545,18.8,6,tj-vasher-1
25,Terren Encalade,Tulane,American,12,39,730,18.7,4,4,91,22.8,1,43,821,19.1,5,terren-encalade-1
26,Tyrie Cleveland,Florida,SEC,9,22,410,18.6,2,2,6,3,0,24,416,17.3,2,tyrie-cleveland-1
27,Malcolm Williams,Coastal Carolina,Sun Belt,11,43,793,18.4,7,12,54,4.5,0,55,847,15.4,7,malcolm-williams-4
28,Jordan Lasley,UCLA,Pac-12,9,69,1264,18.3,9,4,-6,-1.5,0,73,1258,17.2,9,jordan-lasley-1
29,Cedric Wilson,Boise State,MWC,14,83,1511,18.2,7,9,13,1.4,0,92,1524,16.6,7,cedric-wilson-3
30,RJ Turner,Louisiana-Monroe,Sun Belt,10,38,693,18.2,6,1,9,9,0,39,702,18,6,rj-turner-1
31,Anthony Ratliff-Williams,North Carolina,ACC,12,35,630,18,6,1,1,1,0,36,631,17.5,6,anthony-ratliff-williams-1
32,Devonte Boyd,UNLV,MWC,11,34,612,18,3,0,0,,0,34,612,18,3,devonte-boyd-1
33,Anthony Johnson,Buffalo,MAC,12,76,1356,17.8,14,4,-5,-1.3,0,80,1351,16.9,14,anthony-johnson-13
34,Denzel Mims,Baylor,Big 12,12,61,1087,17.8,8,1,-6,-6,0,62,1081,17.4,8,denzel-mims-1
35,Trevon Brown,East Carolina,American,12,60,1069,17.8,7,2,16,8,0,62,1085,17.5,7,trevon-brown-1
36,Turner Smiley,North Texas,CUSA,11,35,623,17.8,5,0,0,,0,35,623,17.8,5,turner-smiley-1
37,Adonis Jennings,Temple,American,13,42,742,17.7,7,2,22,11,0,44,764,17.4,7,adonis-jennings-1
38,Johnathon Johnson,Missouri,SEC,13,41,724,17.7,6,1,0,0,0,42,724,17.2,6,johnathon-johnson-2
39,C.J. Johnson,Wyoming,MWC,12,30,531,17.7,7,2,15,7.5,0,32,546,17.1,7,cj-johnson-4
40,Darnell Mooney,Tulane,American,11,34,599,17.6,4,0,0,,0,34,599,17.6,4,darnell-mooney-1
41,Rhashid Bonnette,Louisiana Tech,CUSA,10,33,582,17.6,2,1,3,3,0,34,585,17.2,2,rhashid-bonnette-1
42,CeeDee Lamb,Oklahoma,Big 12,13,46,807,17.5,7,0,0,,0,46,807,17.5,7,ceedee-lamb-1
43,Papi White,Ohio,MAC,9,36,631,17.5,3,4,46,11.5,0,40,677,16.9,3,papi-white-1
44,Jalen Reagor,TCU,Big 12,14,33,576,17.5,8,8,65,8.1,0,41,641,15.6,8,jalen-reagor-1
45,Diontae Johnson,Toledo,MAC,14,74,1278,17.3,13,2,9,4.5,0,76,1287,16.9,13,diontae-johnson-1
46,Anthony Mahoungou,Purdue,Big Ten,12,40,688,17.2,8,0,0,,0,40,688,17.2,8,anthony-mahoungou-1
47,Kamathi Holsey,Buffalo,MAC,8,32,548,17.1,1,0,0,,0,32,548,17.1,1,kamathi-holsey-1
48,DaMarkus Lodge,Ole Miss,SEC,12,41,698,17,7,0,0,,0,41,698,17,7,damarkus-lodge-1
49,Jester Weah,Pitt,ACC,11,41,698,17,4,0,2,,0,41,700,17.1,4,jester-weah-1
50,Hakeem Butler,Iowa State,Big 12,13,41,697,17,7,0,0,,0,41,697,17,7,hakeem-butler-1
51,Jalen Harvey,Arizona State,Pac-12,11,33,558,16.9,1,1,2,2,0,34,560,16.5,1,jalen-harvey-2
52,D'Wayne Eskridge,Western Michigan,MAC,12,30,506,16.9,3,4,13,3.3,0,34,519,15.3,3,dwayne-eskridge-1
53,Marquez Callaway,Tennessee,SEC,10,24,406,16.9,5,1,4,4,0,25,410,16.4,5,marquez-callaway-1
54,Terry Godwin,Georgia,SEC,13,38,639,16.8,6,0,0,,0,38,639,16.8,6,terry-godwin-1
55,A.J. Brown,Ole Miss,SEC,11,75,1252,16.7,11,0,0,,0,75,1252,16.7,11,aj-brown-3
56,Quintez Cephus,Wisconsin,Big Ten,10,30,501,16.7,6,4,5,1.3,0,34,506,14.9,6,quintez-cephus-1
57,J'Mon Moore,Missouri,SEC,13,65,1082,16.6,10,0,0,,0,65,1082,16.6,10,jmon-moore-2
58,Marquez Valdes-Scantling,South Florida,American,12,53,879,16.6,6,8,108,13.5,1,61,987,16.2,7,marquez-valdes-scantling-1
59,D.K. Metcalf,Ole Miss,SEC,12,39,646,16.6,7,0,0,,0,39,646,16.6,7,dk-metcalf-1
60,Ka'Raun White,West Virginia,Big 12,13,61,1004,16.5,12,0,0,,0,61,1004,16.5,12,karaun-white-1
61,Kalija Lipscomb,Vanderbilt,SEC,12,37,610,16.5,8,3,17,5.7,0,40,627,15.7,8,kalija-lipscomb-1
62,Ricky Smalling,Illinois,Big Ten,11,31,510,16.5,2,0,0,,0,31,510,16.5,2,ricky-smalling-1
63,Noah Fant,Iowa,Big Ten,12,30,494,16.5,11,2,-1,-0.5,0,32,493,15.4,11,noah-fant-1
64,Jon'Vea Johnson,Toledo,MAC,13,42,689,16.4,5,0,0,,0,42,689,16.4,5,jonvea-johnson-1
65,John Diarse,TCU,Big 12,13,35,575,16.4,3,0,0,,0,35,575,16.4,3,john-diarse-1
66,David Sills,West Virginia,Big 12,12,60,980,16.3,18,0,0,,0,60,980,16.3,18,david-sills-1
67,Jaylen Smith,Louisville,ACC,10,60,980,16.3,7,0,0,,0,60,980,16.3,7,jaylen-smith-1
68,Sergio Bailey,Eastern Michigan,MAC,12,54,878,16.3,9,2,25,12.5,0,56,903,16.1,9,sergio-bailey-1
69,Justin McInnis,Arkansas State,Sun Belt,12,49,800,16.3,4,1,3,3,0,50,803,16.1,4,justin-mcinnis-1
70,JJ Arcega-Whiteside,Stanford,Pac-12,11,48,781,16.3,9,0,0,,0,48,781,16.3,9,jj-arcega-whiteside-1
71,Stanley Morgan Jr.,Nebraska,Big Ten,11,61,986,16.2,10,1,2,2,0,62,988,15.9,10,stanley-morgan-jr-1
72,DaeSean Hamilton,Penn State,Big Ten,13,53,857,16.2,9,1,2,2,0,54,859,15.9,9,daesean-hamilton-1
73,Jamarius Way,South Alabama,Sun Belt,11,47,762,16.2,3,6,37,6.2,0,53,799,15.1,3,jamarius-way-1
74,Tony Ellison,Arizona,Pac-12,13,37,598,16.2,5,3,36,12,1,40,634,15.9,6,tony-ellison-1
75,Brandon Presley,UNLV,MWC,12,34,552,16.2,3,5,40,8,0,39,592,15.2,3,brandon-presley-1
76,Jordan Akins,UCF,American,11,32,515,16.1,4,0,0,,0,32,515,16.1,4,jordan-akins-1
77,Courtland Sutton,SMU,American,13,68,1085,16,12,1,2,2,1,69,1087,15.8,13,courtland-sutton-1
78,Javon Wims,Georgia,SEC,14,45,720,16,7,0,0,,0,45,720,16,7,javon-wims-1
79,Darnell Salomon,South Florida,American,10,32,512,16,5,0,0,,0,32,512,16,5,darnell-salomon-1
80,Devin Gray,Cincinnati,American,12,28,444,15.9,3,0,0,,0,28,444,15.9,3,devin-gray-1
81,Jalen Guyton,North Texas,CUSA,12,49,775,15.8,9,3,12,4,0,52,787,15.1,9,jalen-guyton-1
82,Scotty Washington,Wake Forest,ACC,12,45,711,15.8,3,0,0,,0,45,711,15.8,3,scotty-washington-1
83,Brendan O'Leary-Orange,Nevada,MWC,10,39,618,15.8,4,0,0,,0,39,618,15.8,4,brendan-oleary-orange-1
84,Stephen Louis,North Carolina State,ACC,10,37,583,15.8,2,1,-6,-6,0,38,577,15.2,2,stephen-louis-1
85,DeAndre Thompkins,Penn State,Big Ten,13,28,443,15.8,3,0,0,,0,28,443,15.8,3,deandre-thompkins-1
86,Andy Isabella,Massachusetts,Ind,12,65,1020,15.7,10,14,135,9.6,1,79,1155,14.6,11,andy-isabella-1
87,Steven Mitchell,USC,Pac-12,10,41,644,15.7,4,1,10,10,0,42,654,15.6,4,steven-mitchell-1
88,Equanimeous St. Brown,Notre Dame,Ind,12,33,515,15.6,4,0,0,,0,33,515,15.6,4,equanimeous-st-brown-1
89,Mark Andrews,Oklahoma,Big 12,14,62,958,15.5,8,0,0,,0,62,958,15.5,8,mark-andrews-1
90,Dez Fitzpatrick,Louisville,ACC,12,45,699,15.5,9,0,0,,0,45,699,15.5,9,dez-fitzpatrick-1
91,Keke Coutee,Texas Tech,Big 12,13,93,1429,15.4,10,5,15,3,0,98,1444,14.7,10,keke-coutee-1
92,Ryheem Malone,Louisiana,Sun Belt,11,44,676,15.4,4,4,57,14.3,0,48,733,15.3,4,ryheem-malone-1
93,Lucky Jackson,Western Kentucky,CUSA,10,39,600,15.4,3,1,6,6,0,40,606,15.2,3,lucky-jackson-1
94,Calvin Ridley,Alabama,SEC,14,63,967,15.3,5,2,17,8.5,0,65,984,15.1,5,calvin-ridley-1
95,Seth Dawkins,Louisville,ACC,12,42,642,15.3,4,0,0,,0,42,642,15.3,4,seth-dawkins-1
96,A.J. Taylor,Wisconsin,Big Ten,14,31,475,15.3,5,6,26,4.3,0,37,501,13.5,5,aj-taylor-1
97,Anthony Miller,Memphis,American,13,96,1462,15.2,18,10,25,2.5,0,106,1487,14,18,anthony-miller-6
98,Tyre Brady,Marshall,CUSA,11,62,942,15.2,8,0,0,,0,62,942,15.2,8,tyre-brady-1
99,Aaron McLean,Connecticut,American,10,31,472,15.2,2,0,0,,0,31,472,15.2,2,aaron-mclean-1
100,Shane Tucker,Middle Tennessee State,CUSA,10,25,381,15.2,2,3,22,7.3,0,28,403,14.4,2,shane-tucker-1
101,Penny Hart,Georgia State,Sun Belt,12,74,1121,15.1,8,6,27,4.5,0,80,1148,14.4,8,penny-hart-1
102,JD Spielman,Nebraska,Big Ten,11,55,830,15.1,2,10,73,7.3,0,65,903,13.9,2,jd-spielman-1
103,Justin Hobbs,Tulsa,American,11,55,830,15.1,3,0,0,,0,55,830,15.1,3,justin-hobbs-1
104,Dredrick Snelson,UCF,American,12,46,695,15.1,8,2,11,5.5,1,48,706,14.7,9,dredrick-snelson-1
105,Nyqwan Murray,Florida State,ACC,12,40,604,15.1,4,3,15,5,0,43,619,14.4,4,nyqwan-murray-1
106,Thomas Owens,Florida International,CUSA,9,59,887,15,6,1,-1,-1,0,60,886,14.8,6,thomas-owens-1
107,Davon Grayson,East Carolina,American,11,59,886,15,6,6,40,6.7,0,65,926,14.2,6,davon-grayson-1
108,Marcus Green,Louisiana-Monroe,Sun Belt,12,54,812,15,5,14,175,12.5,0,68,987,14.5,5,marcus-green-6
109,A.J. Richardson,Boise State,MWC,11,33,494,15,2,0,0,,0,33,494,15,2,aj-richardson-1
110,Terry McLaurin,Ohio State,Big Ten,13,29,436,15,6,0,0,,0,29,436,15,6,terry-mclaurin-1
111,Ian Thomas,Indiana,Big Ten,9,25,376,15,5,0,0,,0,25,376,15,5,ian-thomas-3
112,Keith Kirkwood,Temple,American,12,45,671,14.9,7,0,0,,0,45,671,14.9,7,keith-kirkwood-1
113,Corey Willis,Central Michigan,MAC,9,45,669,14.9,9,0,0,,0,45,669,14.9,9,corey-willis-1
114,Tony Pollard,Memphis,American,13,36,536,14.9,4,30,230,7.7,2,66,766,11.6,6,tony-pollard-1
115,Phil Mayhue,Memphis,American,11,35,521,14.9,3,0,0,,0,35,521,14.9,3,phil-mayhue-1
116,Chad Beebe,Northern Illinois,MAC,9,28,417,14.9,1,1,-1,-1,0,29,416,14.3,1,chad-beebe-1
117,Trent Bostick,Charlotte,CUSA,11,24,357,14.9,3,1,3,3,0,25,360,14.4,3,trent-bostick-1
118,Mark Chapman,Central Michigan,MAC,13,59,875,14.8,5,2,17,8.5,0,61,892,14.6,5,mark-chapman-2
119,Damion Willis,Troy,Sun Belt,12,42,620,14.8,3,0,0,,0,42,620,14.8,3,damion-willis-1
120,Raelon Singleton,Utah,Pac-12,12,36,531,14.8,4,0,0,,0,36,531,14.8,4,raelon-singleton-1
121,Sadiq Palmer,Massachusetts,Ind,10,35,518,14.8,1,0,0,,0,35,518,14.8,1,sadiq-palmer-1
122,Kelvin Harmon,North Carolina State,ACC,13,69,1017,14.7,4,0,0,,0,69,1017,14.7,4,kelvin-harmon-1
123,Korey Robertson,Southern Mississippi,CUSA,13,76,1106,14.6,12,0,0,,0,76,1106,14.6,12,korey-robertson-1
124,Trent Sherfield,Vanderbilt,SEC,12,50,729,14.6,5,8,92,11.5,1,58,821,14.2,6,trent-sherfield-1
125,Parris Campbell,Ohio State,Big Ten,13,40,584,14.6,3,10,132,13.2,1,50,716,14.3,4,parris-campbell-1
126,Jonathan Nance,Arkansas,SEC,11,37,539,14.6,5,5,62,12.4,0,42,601,14.3,5,jonathan-nance-1
127,Keenan Barnes,Louisiana,Sun Belt,10,37,539,14.6,2,0,0,,0,37,539,14.6,2,keenan-barnes-1
128,Jessie Britt,Massachusetts,Ind,12,29,422,14.6,3,0,0,,0,29,422,14.6,3,jessie-britt-1
129,Isaiah Wright,Temple,American,13,46,668,14.5,4,25,188,7.5,1,71,856,12.1,5,isaiah-wright-1
130,Olabisi Johnson,Colorado State,MWC,12,41,595,14.5,2,0,0,,0,41,595,14.5,2,olabisi-johnson-1
131,Gabriel Davis,UCF,American,10,27,391,14.5,4,0,0,,0,27,391,14.5,4,gabriel-davis-1
132,Christian Booker,Arkansas State,Sun Belt,9,25,363,14.5,6,1,-3,-3,0,26,360,13.8,6,christian-booker-1
133,Elijah King,Texas State,Sun Belt,11,52,750,14.4,3,1,6,6,0,53,756,14.3,3,elijah-king-1
134,Ike Lewis,Appalachian State,Sun Belt,13,51,733,14.4,8,3,31,10.3,0,54,764,14.1,8,ike-lewis-2
135,Rico Bussey Jr.,North Texas,CUSA,13,47,677,14.4,7,0,0,,0,47,677,14.4,7,rico-bussey-jr-1
136,Tyler Conklin,Central Michigan,MAC,8,35,504,14.4,5,0,0,,0,35,504,14.4,5,tyler-conklin-1
137,Austin Wolf,Akron,MAC,10,33,476,14.4,5,0,0,,0,33,476,14.4,5,austin-wolf-1
138,Sam Martin,Miami (OH),MAC,10,25,359,14.4,3,0,0,,0,25,359,14.4,3,sam-martin-3
139,Ben Skowronek,Northwestern,Big Ten,13,45,644,14.3,5,0,0,,0,45,644,14.3,5,ben-skowronek-1
140,Hergy Mayala,Connecticut,American,9,43,615,14.3,7,0,0,,0,43,615,14.3,7,hergy-mayala-1
141,Albert Okwuegbunam,Missouri,SEC,9,29,415,14.3,11,0,0,,0,29,415,14.3,11,albert-okwuegbunam-1
142,Micah Simon,Brigham Young,Ind,12,27,386,14.3,3,0,0,,0,27,386,14.3,3,micah-simon-1
143,Michael Gallup,Colorado State,MWC,13,100,1418,14.2,7,0,0,,0,100,1418,14.2,7,michael-gallup-1
144,Jaleel Scott,New Mexico State,Sun Belt,12,76,1079,14.2,9,0,0,,0,76,1079,14.2,9,jaleel-scott-1
145,Steven Sims Jr.,Kansas,Big 12,11,59,839,14.2,6,5,5,1,0,64,844,13.2,6,steven-sims-jr-1
146,Tyler Vaughns,USC,Pac-12,13,57,809,14.2,5,0,0,,0,57,809,14.2,5,tyler-vaughns-1
147,Collin Johnson,Texas,Big 12,13,54,765,14.2,2,0,-7,,0,54,758,14,2,collin-johnson-2
148,John Ursua,Hawaii,MWC,6,47,667,14.2,5,0,0,,0,47,667,14.2,5,john-ursua-1
149,Trey Hartley,San Jose State,MWC,12,37,527,14.2,2,0,0,,0,37,527,14.2,2,trey-hartley-1
150,Tommy Sweeney,Boston College,ACC,12,36,512,14.2,4,0,0,,0,36,512,14.2,4,tommy-sweeney-1
151,Steven Dunbar,Houston,American,12,76,1070,14.1,3,0,0,,0,76,1070,14.1,3,steven-dunbar-1
152,Kanawai Noa,California,Pac-12,11,56,788,14.1,4,0,0,,0,56,788,14.1,4,kanawai-noa-1
153,Felton Davis III,Michigan State,Big Ten,11,55,776,14.1,9,1,16,16,0,56,792,14.1,9,felton-davis-iii-1
154,Brendan Cope,Ohio,MAC,10,35,494,14.1,4,1,-2,-2,0,36,492,13.7,4,brendan-cope-1
155,K.J. Osborn,Buffalo,MAC,12,35,493,14.1,4,4,22,5.5,1,39,515,13.2,5,kj-osborn-1
156,Shi Smith,South Carolina,SEC,12,29,409,14.1,3,0,0,,0,29,409,14.1,3,shi-smith-1
157,Jay MacIntyre,Colorado,Pac-12,10,28,396,14.1,2,1,1,1,0,29,397,13.7,2,jay-macintyre-1
158,Darren Carrington,Utah,Pac-12,12,70,980,14,6,0,0,,0,70,980,14,6,darren-carrington-1
159,Micah Holder,San Diego State,MWC,11,43,602,14,2,3,30,10,0,46,632,13.7,2,micah-holder-1
160,Cody White,Michigan State,Big Ten,11,35,490,14,4,4,19,4.8,0,39,509,13.1,4,cody-white-3
161,Jimmy Williams,East Carolina,American,9,32,447,14,3,1,2,2,0,33,449,13.6,3,jimmy-williams-9
162,CJ Windham,Middle Tennessee State,CUSA,12,25,351,14,1,0,0,,0,25,351,14,1,cj-windham-1
163,Brycen Hopkins,Purdue,Big Ten,11,25,349,14,3,0,0,,0,25,349,14,3,brycen-hopkins-1
164,Evan Fairs,Kansas,Big 12,9,24,335,14,1,0,0,,0,24,335,14,1,evan-fairs-1
165,N'Keal Harry,Arizona State,Pac-12,13,82,1142,13.9,8,13,65,5,0,95,1207,12.7,8,nkeal-harry-1
166,Brian Williams,Louisiana-Monroe,Sun Belt,11,45,626,13.9,4,1,2,2,1,46,628,13.7,5,brian-williams-14
167,Teo Redding,Bowling Green State,MAC,11,45,624,13.9,8,0,0,,0,45,624,13.9,8,teo-redding-1
168,Sam Harris,South Alabama,Sun Belt,11,41,570,13.9,2,0,0,,0,41,570,13.9,2,sam-harris-2
169,Macan Wilson,Northwestern,Big Ten,11,32,446,13.9,1,0,0,,0,32,446,13.9,1,macan-wilson-1
170,Chase Claypool,Notre Dame,Ind,11,29,402,13.9,2,2,-3,-1.5,0,31,399,12.9,2,chase-claypool-1
171,Demornay Pierson-El,Nebraska,Big Ten,12,45,623,13.8,5,4,32,8,0,49,655,13.4,5,demornay-pierson-el-1
172,Andrew Meyer,Ohio,MAC,12,35,483,13.8,2,1,-1,-1,0,36,482,13.4,2,andrew-meyer-1
173,Omar Bayless,Arkansas State,Sun Belt,11,31,428,13.8,6,2,-3,-1.5,0,33,425,12.9,6,omar-bayless-1
174,Chris Murray,Arkansas State,Sun Belt,12,51,701,13.7,9,3,3,1,0,54,704,13,9,chris-murray-2
175,Auden Tate,Florida State,ACC,12,40,548,13.7,10,0,0,,0,40,548,13.7,10,auden-tate-1
176,JaQuan Blackwell,San Jose State,MWC,11,32,437,13.7,2,0,0,,0,32,437,13.7,2,jaquan-blackwell-1
177,Matt Vandeberg,Iowa,Big Ten,13,28,384,13.7,2,0,0,,0,28,384,13.7,2,matt-vandeberg-1
178,Tavin Richardson,Kentucky,SEC,12,27,371,13.7,1,0,0,,0,27,371,13.7,1,tavin-richardson-1
179,Mathew Sexton,Eastern Michigan,MAC,12,26,357,13.7,2,0,0,,0,26,357,13.7,2,mathew-sexton-1
180,Cam Phillips,Virginia Tech,ACC,12,71,964,13.6,7,1,10,10,0,72,974,13.5,7,cam-phillips-1
181,Wyatt Demps,Nevada,MWC,12,67,908,13.6,11,0,0,,0,67,908,13.6,11,wyatt-demps-1
182,McLane Mannix,Nevada,MWC,12,57,778,13.6,6,2,3,1.5,0,59,781,13.2,6,mclane-mannix-1
183,Greg Dortch,Wake Forest,ACC,8,53,722,13.6,9,7,9,1.3,0,60,731,12.2,9,greg-dortch-1
184,Noah Togiai,Oregon State,Pac-12,9,34,461,13.6,2,0,0,,0,34,461,13.6,2,noah-togiai-1
185,Jay Griffin IV,New Mexico,MWC,12,29,393,13.6,4,13,116,8.9,1,42,509,12.1,5,jay-griffin-iv-1
186,John Niupalau,Eastern Michigan,MAC,9,27,368,13.6,4,0,0,,0,27,368,13.6,4,john-niupalau-1
187,Ky'Jon Tyler,Coastal Carolina,Sun Belt,11,23,313,13.6,2,11,73,6.6,0,34,386,11.4,2,kyjon-tyler-1
188,Shay Fields,Colorado,Pac-12,12,46,623,13.5,4,0,0,,0,46,623,13.5,4,shay-fields-1
189,Renard Bell,Washington State,Pac-12,13,40,538,13.5,3,0,0,,0,40,538,13.5,3,renard-bell-1
190,Workpeh Kofa,Charlotte,CUSA,9,25,338,13.5,1,2,3,1.5,0,27,341,12.6,1,workpeh-kofa-1
191,Taysir Mack,Indiana,Big Ten,6,23,310,13.5,3,0,0,,0,23,310,13.5,3,taysir-mack-1
192,Alfonso Onunwor,Idaho,Sun Belt,11,64,856,13.4,8,0,0,,0,64,856,13.4,8,alfonso-onunwor-1
193,Thomas Geddis,Cincinnati,American,11,29,388,13.4,3,0,0,,0,29,388,13.4,3,thomas-geddis-1
194,Dawson Knox,Ole Miss,SEC,8,24,321,13.4,0,0,0,,0,24,321,13.4,0,dawson-knox-1
195,Allen Lazard,Iowa State,Big 12,13,71,941,13.3,10,0,0,,0,71,941,13.3,10,allen-lazard-1
196,Shun Brown,Arizona,Pac-12,13,43,573,13.3,6,5,51,10.2,0,48,624,13,6,shun-brown-1
197,Josh Stewart,UTSA,CUSA,11,39,518,13.3,3,0,0,,0,39,518,13.3,3,josh-stewart-2
198,Collin Lisa,UAB,CUSA,12,33,439,13.3,1,1,0,0,0,34,439,12.9,1,collin-lisa-1
199,Chris Taylor,Duke,ACC,11,25,332,13.3,1,0,0,,0,25,332,13.3,1,chris-taylor-4
200,KeeSean Johnson,Fresno State,MWC,14,77,1013,13.2,8,1,0,0,0,78,1013,13,8,keesean-johnson-1
201,Michael Lawrence,North Texas,CUSA,14,62,819,13.2,4,0,0,,0,62,819,13.2,4,michael-lawrence-1
202,Deon Yelder,Western Kentucky,CUSA,12,52,688,13.2,7,2,15,7.5,1,54,703,13,8,deon-yelder-1
203,Deondre Douglas,Troy,Sun Belt,12,48,628,13.1,4,3,43,14.3,1,51,671,13.2,5,deondre-douglas-1
204,Dillon Stoner,Oklahoma State,Big 12,12,44,576,13.1,6,0,0,,0,44,576,13.1,6,dillon-stoner-1
205,Travis Fulgham,Old Dominion,CUSA,11,30,394,13.1,1,0,0,,0,30,394,13.1,1,travis-fulgham-1
206,Deontay Burnett,USC,Pac-12,14,86,1114,13,9,2,-2,-1,0,88,1112,12.6,9,deontay-burnett-1
207,Vic Wharton,California,Pac-12,12,67,871,13,5,1,-5,-5,0,68,866,12.7,5,vic-wharton-1
208,Juwan Johnson,Penn State,Big Ten,13,54,701,13,1,0,0,,0,54,701,13,1,juwan-johnson-1
209,Thomas Hennigan,Appalachian State,Sun Belt,12,45,585,13,7,0,0,,0,45,585,13,7,thomas-hennigan-1
210,Brandon Johnson,Tennessee,SEC,10,37,482,13,1,0,0,,0,37,482,13,1,brandon-johnson-11
211,Ryan Smith,Miami (OH),MAC,10,35,454,13,4,0,0,,0,35,454,13,4,ryan-smith-9
212,Jordan Nathan,Utah State,MWC,13,25,324,13,2,7,30,4.3,0,32,354,11.1,2,jordan-nathan-1
213,D.J. Moore,Maryland,Big Ten,12,80,1033,12.9,8,5,61,12.2,1,85,1094,12.9,9,dj-moore-3
214,Christian Kirk,Texas A&M,SEC,13,71,919,12.9,10,4,31,7.8,0,75,950,12.7,10,christian-kirk-1
215,Darren Andrews,UCLA,Pac-12,9,60,773,12.9,10,4,49,12.3,0,64,822,12.8,10,darren-andrews-1
216,Tabari Hines,Wake Forest,ACC,12,53,683,12.9,7,2,-6,-3,0,55,677,12.3,7,tabari-hines-1
217,Doni Dowling,Virginia,ACC,13,50,647,12.9,5,0,0,,0,50,647,12.9,5,doni-dowling-1
218,Jalen McCleskey,Oklahoma State,Big 12,12,50,645,12.9,5,0,0,,0,50,645,12.9,5,jalen-mccleskey-1
219,Blake Mack,Arkansas State,Sun Belt,12,48,618,12.9,7,0,0,,0,48,618,12.9,7,blake-mack-1
220,Jordan Veasy,California,Pac-12,12,38,491,12.9,6,0,0,,0,38,491,12.9,6,jordan-veasy-1
221,Caleb Wilson,UCLA,Pac-12,5,38,490,12.9,1,0,0,,0,38,490,12.9,1,caleb-wilson-2
222,Kerry Thomas,UTSA,CUSA,9,35,453,12.9,4,2,6,3,0,37,459,12.4,4,kerry-thomas-1
223,Pooh Stricklin,Baylor,Big 12,8,32,414,12.9,1,0,0,,0,32,414,12.9,1,pooh-stricklin-1
224,Johnathan Boone,New Mexico State,Sun Belt,9,31,399,12.9,1,0,0,,0,31,399,12.9,1,johnathan-boone-1
225,Steve Ishmael,Syracuse,ACC,12,105,1347,12.8,7,0,0,,0,105,1347,12.8,7,steve-ishmael-1
226,Teddy Veal,Louisiana Tech,CUSA,13,74,950,12.8,7,4,6,1.5,0,78,956,12.3,7,teddy-veal-1
227,A.J. Coney,Akron,MAC,14,43,551,12.8,3,0,0,,0,43,551,12.8,3,aj-coney-1
228,Harrison Bryant,Florida Atlantic,CUSA,10,32,408,12.8,5,0,0,,0,32,408,12.8,5,harrison-bryant-1
229,Deon Cain,Clemson,ACC,14,58,734,12.7,6,0,0,,0,58,734,12.7,6,deon-cain-1
230,Hayden Hurst,South Carolina,SEC,13,44,559,12.7,2,9,30,3.3,1,53,589,11.1,3,hayden-hurst-1
231,Cam Serigne,Wake Forest,ACC,11,44,556,12.6,9,0,0,,0,44,556,12.6,9,cam-serigne-1
232,Charles Nelson,Oregon,Pac-12,10,32,404,12.6,1,11,25,2.3,1,43,429,10,2,charles-nelson-2
233,Akrum Wadley,Iowa,Big Ten,13,28,353,12.6,3,252,1109,4.4,10,280,1462,5.2,13,akrum-wadley-1
234,Dijon Paschal,Arkansas State,Sun Belt,10,25,315,12.6,1,0,0,,0,25,315,12.6,1,dijon-paschal-1
235,Andre Wilson,UAB,CUSA,13,54,677,12.5,6,3,27,9,0,57,704,12.4,6,andre-wilson-1
236,Marchie Murdock,Iowa State,Big 12,12,41,513,12.5,5,0,0,,0,41,513,12.5,5,marchie-murdock-1
237,Marcel Williams,Marshall,CUSA,9,41,512,12.5,2,1,3,3,0,42,515,12.3,2,marcel-williams-2
238,Brady Jones,UTSA,CUSA,11,26,325,12.5,2,1,-11,-11,0,27,314,11.6,2,brady-jones-2
239,Bryan Edwards,South Carolina,SEC,13,64,793,12.4,5,4,19,4.8,0,68,812,11.9,5,bryan-edwards-1
240,Kobay White,Boston College,ACC,12,34,423,12.4,2,0,0,,0,34,423,12.4,2,kobay-white-1
241,Xavier Lane,Western Kentucky,CUSA,8,27,336,12.4,0,0,0,,0,27,336,12.4,0,xavier-lane-1
242,Braxton Berrios,Miami (FL),ACC,13,55,679,12.3,9,0,0,,0,55,679,12.3,9,braxton-berrios-1
243,Keenen Johnson,Tulsa,American,10,44,539,12.3,1,1,4,4,0,45,543,12.1,1,keenen-johnson-1
244,Rafael Araujo-Lopes,Pitt,ACC,11,43,531,12.3,2,5,6,1.2,0,48,537,11.2,2,rafael-araujo-lopes-1
245,Spencer Tears,Northern Illinois,MAC,13,43,528,12.3,4,4,-5,-1.3,0,47,523,11.1,4,spencer-tears-1
246,Dillon Mitchell,Oregon,Pac-12,11,42,517,12.3,4,4,6,1.5,0,46,523,11.4,4,dillon-mitchell-1
247,Detrich Clark,Colorado State,MWC,11,41,504,12.3,6,15,40,2.7,0,56,544,9.7,6,detrich-clark-1
248,Willie Johnson,Marshall,CUSA,11,36,443,12.3,4,0,0,,0,36,443,12.3,4,willie-johnson-5
249,Grant Perry,Michigan,Big Ten,9,25,307,12.3,1,0,0,,0,25,307,12.3,1,grant-perry-1
250,T.J. Rahming,Duke,ACC,13,65,795,12.2,2,4,3,0.8,0,69,798,11.6,2,tj-rahming-1
251,Ja'Marcus Bradley,Louisiana,Sun Belt,12,39,475,12.2,2,2,25,12.5,0,41,500,12.2,2,jamarcus-bradley-1
252,Deon Stewart,Arkansas,SEC,11,33,404,12.2,3,8,10,1.3,0,41,414,10.1,3,deon-stewart-1
253,Darren Woods Jr,UNLV,MWC,12,30,366,12.2,0,3,30,10,0,33,396,12,0,darren-woods-jr-1
254,Demari Simpkins,Utah,Pac-12,13,29,354,12.2,1,4,-16,-4,0,33,338,10.2,1,demari-simpkins-1
255,Ty Lee,Middle Tennessee State,CUSA,13,79,955,12.1,5,39,109,2.8,1,118,1064,9,6,ty-lee-1
256,Dante Pettis,Washington,Pac-12,13,63,761,12.1,7,3,50,16.7,0,66,811,12.3,7,dante-pettis-1
257,Ben Johnson,Kansas,Big 12,11,30,363,12.1,1,0,0,,0,30,363,12.1,1,ben-johnson-2
258,Tamir Jones,Georgia State,Sun Belt,11,33,396,12,0,0,0,,0,33,396,12,0,tamir-jones-1
259,Malik Stanley,South Alabama,Sun Belt,8,27,324,12,3,1,3,3,0,28,327,11.7,3,malik-stanley-1
260,Tavares Martin Jr.,Washington State,Pac-12,11,70,831,11.9,9,0,0,,0,70,831,11.9,9,tavares-martin-jr-1
261,Adam Breneman,Massachusetts,Ind,11,64,764,11.9,4,0,0,,0,64,764,11.9,4,adam-breneman-1
262,Ron'Quavion Tarver,Utah State,MWC,13,48,569,11.9,7,0,9,,0,48,578,12,7,ronquavion-tarver-1
263,Antoine Porter,Eastern Michigan,MAC,12,46,548,11.9,4,1,-16,-16,0,47,532,11.3,4,antoine-porter-1
264,Troy Fumagalli,Wisconsin,Big Ten,12,46,547,11.9,4,0,0,,0,46,547,11.9,4,troy-fumagalli-2
265,Christopher Herndon IV,Miami (FL),ACC,11,40,477,11.9,4,0,0,,0,40,477,11.9,4,christopher-herndon-iv-1
266,Timmy Hernandez,Oregon State,Pac-12,11,30,357,11.9,3,0,0,,0,30,357,11.9,3,timmy-hernandez-1
267,Jordan Villamin,Oregon State,Pac-12,9,30,356,11.9,1,0,0,,0,30,356,11.9,1,jordan-villamin-1
268,Dalyn Dawkins,Colorado State,MWC,13,26,310,11.9,1,226,1399,6.2,8,252,1709,6.8,9,dalyn-dawkins-1
269,Taivon Jacobs,Maryland,Big Ten,12,47,553,11.8,5,2,6,3,0,49,559,11.4,5,taivon-jacobs-1
270,Devin Ross,Colorado,Pac-12,10,43,508,11.8,2,3,21,7,0,46,529,11.5,2,devin-ross-2
271,Isaiah Harper,Old Dominion,CUSA,11,39,462,11.8,0,14,59,4.2,0,53,521,9.8,0,isaiah-harper-1
272,Aleva Hifo,Brigham Young,Ind,10,37,437,11.8,2,0,0,,0,37,437,11.8,2,aleva-hifo-1
273,Kamrin Solomon,Florida Atlantic,CUSA,11,33,388,11.8,1,5,22,4.4,0,38,410,10.8,1,kamrin-solomon-1
274,Tay Martin,Washington State,Pac-12,11,31,366,11.8,6,0,0,,0,31,366,11.8,6,tay-martin-1
275,Jordan Cunningham,North Carolina,ACC,11,26,307,11.8,1,0,0,,0,26,307,11.8,1,jordan-cunningham-1
276,Jeff Smith,Boston College,ACC,13,25,296,11.8,0,10,107,10.7,1,35,403,11.5,1,jeff-smith-10
277,Simmie Cobbs,Indiana,Big Ten,12,72,841,11.7,8,0,0,,1,72,841,11.7,9,simmie-cobbs-1
278,Willie Wright,Florida Atlantic,CUSA,12,56,657,11.7,6,19,139,7.3,1,75,796,10.6,7,willie-wright-4
279,Saquon Barkley,Penn State,Big Ten,13,54,632,11.7,3,217,1271,5.9,18,271,1903,7,21,saquon-barkley-1
280,Otis Anderson,UCF,American,12,30,351,11.7,3,69,494,7.2,4,99,845,8.5,7,otis-anderson-1
281,Kyle Williams,Arizona State,Pac-12,13,66,763,11.6,7,10,86,8.6,0,76,849,11.2,7,kyle-williams-8
282,Sean Savoy,Virginia Tech,ACC,12,39,454,11.6,4,24,116,4.8,2,63,570,9,6,sean-savoy-1
283,Lil'Jordan Humphrey,Texas,Big 12,11,37,431,11.6,1,6,41,6.8,1,43,472,11,2,liljordan-humphrey-1
284,Donnie Ernsberger,Western Michigan,MAC,12,34,394,11.6,4,0,0,,0,34,394,11.6,4,donnie-ernsberger-1
285,Eric Kumah,Virginia Tech,ACC,10,28,324,11.6,2,0,0,,0,28,324,11.6,2,eric-kumah-1
286,Dylan Cantrell,Texas Tech,Big 12,13,71,816,11.5,7,1,3,3,1,72,819,11.4,8,dylan-cantrell-1
287,Jakobi Meyers,North Carolina State,ACC,12,63,727,11.5,5,5,-5,-1,0,68,722,10.6,5,jakobi-meyers-1
288,Scott Miller,Bowling Green State,MAC,12,63,722,11.5,4,2,22,11,0,65,744,11.4,4,scott-miller-3
289,Anthony Muse,New Mexico State,Sun Belt,12,39,449,11.5,2,0,0,,0,39,449,11.5,2,anthony-muse-1
290,Keelan Ewaliko,Hawaii,MWC,12,26,299,11.5,0,0,0,,0,26,299,11.5,0,keelan-ewaliko-1
291,Dylan Collie,Hawaii,MWC,11,56,636,11.4,4,1,23,23,0,57,659,11.6,4,dylan-collie-1
292,Jhamon Ausbon,Texas A&M,SEC,12,50,571,11.4,3,0,0,,0,50,571,11.4,3,jhamon-ausbon-1
293,Kendrick Edwards,Arkansas State,Sun Belt,12,38,434,11.4,3,0,0,,0,38,434,11.4,3,kendrick-edwards-1
294,Tevaris McCormick,Troy,Sun Belt,12,37,421,11.4,3,5,14,2.8,0,42,435,10.4,3,tevaris-mccormick-1
295,Gary Jennings,West Virginia,Big 12,13,97,1096,11.3,1,0,0,,0,97,1096,11.3,1,gary-jennings-1
296,Cameron Echols-Luper,Western Kentucky,CUSA,9,42,473,11.3,4,2,6,3,0,44,479,10.9,4,cameron-echols-luper-1
297,Jared Murphy,Miami (OH),MAC,12,38,430,11.3,2,1,3,3,0,39,433,11.1,2,jared-murphy-1
298,Patrick Smith,Middle Tennessee State,CUSA,10,29,329,11.3,2,0,0,,0,29,329,11.3,2,patrick-smith-1
299,Bryce Bobo,Colorado,Pac-12,12,62,693,11.2,5,1,9,9,0,63,702,11.1,5,bryce-bobo-1
300,Garrett Johnson,Kentucky,SEC,12,48,539,11.2,2,2,12,6,0,50,551,11,2,garrett-johnson-3
301,Aaron Fuller,Washington,Pac-12,10,26,291,11.2,1,0,0,,0,26,291,11.2,1,aaron-fuller-1
302,Phillip Lindsay,Colorado,Pac-12,12,23,257,11.2,1,301,1474,4.9,14,324,1731,5.3,15,phillip-lindsay-1
303,Linell Bonner,Houston,American,11,80,889,11.1,5,1,-2,-2,0,81,887,11,5,linell-bonner-1
304,Kahlil Lewis,Cincinnati,American,12,61,676,11.1,7,2,33,16.5,0,63,709,11.3,7,kahlil-lewis-1
305,Dax Raymond,Utah State,MWC,12,41,456,11.1,1,0,0,,0,41,456,11.1,1,dax-raymond-1
306,David Ungerer,Idaho,Sun Belt,12,39,432,11.1,6,0,0,,0,39,432,11.1,6,david-ungerer-1
307,Emanuel Thompson,Troy,Sun Belt,11,38,420,11.1,0,0,0,,0,38,420,11.1,0,emanuel-thompson-1
308,Tyler Hoppes,Nebraska,Big Ten,12,34,377,11.1,3,0,0,,0,34,377,11.1,3,tyler-hoppes-1
309,Mark Quattlebaum,Charlotte,CUSA,11,31,343,11.1,1,0,0,,0,31,343,11.1,1,mark-quattlebaum-1
310,Pharoah McKever,Florida International,CUSA,11,27,301,11.1,3,0,0,,0,27,301,11.1,3,pharoah-mckever-1
311,Greg Campbell Jr.,UTSA,CUSA,10,27,300,11.1,0,8,75,9.4,0,35,375,10.7,0,greg-campbell-3
312,Tre Walker,San Jose State,MWC,9,26,288,11.1,1,0,0,,0,26,288,11.1,1,tre-walker-3
313,Van Jefferson,Ole Miss,SEC,10,42,456,10.9,1,0,0,,0,42,456,10.9,1,van-jefferson-1
314,Reggie Hemphill-Mapps,Texas,Big 12,12,37,402,10.9,0,8,31,3.9,0,45,433,9.6,0,reggie-hemphill-mapps-1
315,Quin Jernighan,Western Kentucky,CUSA,10,36,393,10.9,3,1,-3,-3,0,37,390,10.5,3,quin-jernighan-1
316,Keyion Dixon,Connecticut,American,11,33,360,10.9,1,9,41,4.6,0,42,401,9.5,1,keyion-dixon-1
317,OrTre Smith,South Carolina,SEC,10,30,326,10.9,3,0,0,,0,30,326,10.9,3,ortre-smith-1
318,Marcus Baugh,Ohio State,Big Ten,14,28,304,10.9,5,1,5,5,0,29,309,10.7,5,marcus-baugh-1
319,Maurice Ffrench,Pitt,ACC,11,25,272,10.9,0,9,71,7.9,0,34,343,10.1,0,maurice-ffrench-1
320,Mike Dudek,Illinois,Big Ten,7,24,262,10.9,1,0,0,,0,24,262,10.9,1,mike-dudek-1
321,Trey Quinn,SMU,American,13,114,1236,10.8,13,1,0,0,0,115,1236,10.7,13,trey-quinn-1
322,Christian Blake,Northern Illinois,MAC,13,41,442,10.8,4,16,58,3.6,0,57,500,8.8,4,christian-blake-1
323,Garrett Dickerson,Northwestern,Big Ten,11,38,410,10.8,4,1,-1,-1,0,39,409,10.5,4,garrett-dickerson-1
324,Dezmon Patmon,Washington State,Pac-12,9,35,379,10.8,0,0,0,,0,35,379,10.8,0,dezmon-patmon-1
325,Allen Staggers,Southern Mississippi,CUSA,13,44,471,10.7,5,8,64,8,0,52,535,10.3,5,allen-staggers-1
326,Trenton Irwin,Stanford,Pac-12,14,43,461,10.7,2,0,0,,0,43,461,10.7,2,trenton-irwin-1
327,Melvin Vaughn,Old Dominion,CUSA,8,33,354,10.7,4,0,0,,0,33,354,10.7,4,melvin-vaughn-1
328,Theo Howard,UCLA,Pac-12,13,56,594,10.6,4,2,0,0,0,58,594,10.2,4,theo-howard-1
329,Matt Bushman,Brigham Young,Ind,13,49,520,10.6,3,0,0,,0,49,520,10.6,3,matt-bushman-1
330,OJ Clark,New Mexico State,Sun Belt,11,47,500,10.6,3,0,0,,0,47,500,10.6,3,oj-clark-1
331,Charles Standberry,Louisville,ACC,13,29,306,10.6,4,0,0,,0,29,306,10.6,4,charles-standberry-1
332,Olamide Zaccheaus,Virginia,ACC,13,85,895,10.5,5,27,182,6.7,1,112,1077,9.6,6,olamide-zaccheaus-1
333,Jake Roh,Boise State,MWC,11,39,410,10.5,9,7,28,4,2,46,438,9.5,11,jake-roh-1
334,Sean Modster,Boise State,MWC,14,32,335,10.5,3,0,0,,0,32,335,10.5,3,sean-modster-1
335,Malik Turner,Illinois,Big Ten,10,31,326,10.5,0,0,0,,0,31,326,10.5,0,malik-turner-1
336,Gregory Hogan,New Mexico State,Sun Belt,10,26,272,10.5,1,0,0,,0,26,272,10.5,1,gregory-hogan-1
337,Chris Davis,New Mexico,MWC,11,25,262,10.5,1,0,0,,0,25,262,10.5,1,chris-davis-12
338,Nick Easley,Iowa,Big Ten,13,51,530,10.4,4,2,11,5.5,0,53,541,10.2,4,nick-easley-1
339,Justin Holmes,San Jose State,MWC,11,26,270,10.4,2,0,0,,0,26,270,10.4,2,justin-holmes-2
340,Justin Hall,Ball State,MAC,12,78,801,10.3,3,11,59,5.4,0,89,860,9.7,3,justin-hall-3
341,Jacob Sannon,Idaho,Sun Belt,11,59,608,10.3,1,0,0,,0,59,608,10.3,1,jacob-sannon-1
342,Ray-Ray McCloud,Clemson,ACC,14,49,503,10.3,1,6,30,5,0,55,533,9.7,1,ray-ray-mccloud-1
343,Desmon White,TCU,Big 12,13,41,423,10.3,5,2,9,4.5,0,43,432,10,5,desmon-white-1
344,Keith Gavin,Florida State,ACC,10,27,278,10.3,0,1,6,6,0,28,284,10.1,0,keith-gavin-1
345,Talon Shumway,Brigham Young,Ind,11,25,257,10.3,0,0,0,,0,25,257,10.3,0,talon-shumway-1
346,Ethan Wolf,Tennessee,SEC,11,24,246,10.3,3,0,0,,0,24,246,10.3,3,ethan-wolf-1
347,Ervin Phillips,Syracuse,ACC,12,89,904,10.2,4,11,76,6.9,1,100,980,9.8,5,ervin-phillips-1
348,Flynn Nagel,Northwestern,Big Ten,13,48,489,10.2,2,1,4,4,0,49,493,10.1,2,flynn-nagel-1
349,Ammon Barker,Hawaii,MWC,11,39,398,10.2,1,0,0,,0,39,398,10.2,1,ammon-barker-1
350,Brad Anderson,Middle Tennessee State,CUSA,9,33,338,10.2,3,89,491,5.5,0,122,829,6.8,3,brad-anderson-3
351,Whop Philyor,Indiana,Big Ten,10,33,335,10.2,3,5,15,3,0,38,350,9.2,3,whop-philyor-1
352,Jesse Jackson,Mississippi State,SEC,12,27,276,10.2,0,2,8,4,0,29,284,9.8,0,jesse-jackson-1
353,Samson Nacua,Utah,Pac-12,10,29,294,10.1,1,1,3,3,0,30,297,9.9,1,samson-nacua-1
354,Alexander Mattison,Boise State,MWC,14,28,284,10.1,1,212,1086,5.1,12,240,1370,5.7,13,alexander-mattison-1
355,Jerome Washington,Rutgers,Big Ten,11,28,282,10.1,1,1,-2,-2,0,29,280,9.7,1,jerome-washington-1
356,Tyler Mabry,Buffalo,MAC,11,24,242,10.1,1,0,0,,0,24,242,10.1,1,tyler-mabry-2
357,Hunter Renfrow,Clemson,ACC,14,60,602,10,3,0,0,,0,60,602,10,3,hunter-renfrow-1
358,Isaiah Zuber,Kansas State,Big 12,13,51,510,10,4,2,35,17.5,0,53,545,10.3,4,isaiah-zuber-1
359,Darrell Stewart Jr.,Michigan State,Big Ten,13,50,501,10,2,20,140,7,0,70,641,9.2,2,darrell-stewart-jr-1
360,Trever Ryen,Iowa State,Big 12,13,47,469,10,1,2,7,3.5,0,49,476,9.7,1,trever-ryen-1
361,Riley Miller,Ball State,MAC,11,30,300,10,1,0,0,,0,30,300,10,1,riley-miller-1
362,Da'Mari Scott,Fresno State,MWC,14,57,566,9.9,1,14,93,6.6,0,71,659,9.3,1,damari-scott-1
363,Mike Gesicki,Penn State,Big Ten,13,57,563,9.9,9,0,0,,0,57,563,9.9,9,mike-gesicki-1
364,C.J. Duncan,Vanderbilt,SEC,12,52,517,9.9,5,0,10,,0,52,527,10.1,5,cj-duncan-1
365,Quay Johnson,East Carolina,American,10,47,464,9.9,3,3,3,1,0,50,467,9.3,3,quay-johnson-1
366,Ito Smith,Southern Mississippi,CUSA,13,40,396,9.9,2,248,1415,5.7,13,288,1811,6.3,15,ito-smith-1
367,Devin Butler,Syracuse,ACC,12,33,327,9.9,1,2,14,7,0,35,341,9.7,1,devin-butler-2
368,K.J. Hill,Ohio State,Big Ten,14,56,549,9.8,3,2,1,0.5,0,58,550,9.5,3,kj-hill-1
369,Jonathan Ward,Central Michigan,MAC,13,48,470,9.8,3,178,1024,5.8,10,226,1494,6.6,13,jonathan-ward-3
370,Eric Cooper,Central Michigan,MAC,10,29,285,9.8,2,0,0,,0,29,285,9.8,2,eric-cooper-1
371,Deshaunte Jones,Iowa State,Big 12,13,28,273,9.8,0,0,0,,0,28,273,9.8,0,deshaunte-jones-1
372,Kelvin Smith,North Texas,CUSA,13,27,264,9.8,0,0,0,,0,27,264,9.8,0,kelvin-smith-3
373,Ryan Davis,Auburn,SEC,14,84,815,9.7,5,0,0,,0,84,815,9.7,5,ryan-davis-5
374,Brandon Powell,Florida,SEC,11,42,406,9.7,3,4,15,3.8,1,46,421,9.2,4,brandon-powell-1
375,Sean McKeon,Michigan,Big Ten,12,31,301,9.7,3,0,0,,0,31,301,9.7,3,sean-mckeon-1
376,Kyle Hicks,TCU,Big 12,12,30,291,9.7,1,139,637,4.6,4,169,928,5.5,5,kyle-hicks-1
377,Ventell Bryant,Temple,American,10,29,280,9.7,0,0,0,,0,29,280,9.7,0,ventell-bryant-1
378,Terry Juniel,UTEP,CUSA,12,23,224,9.7,0,2,4,2,0,25,228,9.1,0,terry-juniel-1
379,Gregory Phillips,Purdue,Big Ten,12,44,424,9.6,2,2,26,13,0,46,450,9.8,2,gregory-phillips-1
380,KaVontae Turpin,TCU,Big 12,14,41,394,9.6,1,11,86,7.8,2,52,480,9.2,3,kavontae-turpin-1
381,Quayvon Skanes,Connecticut,American,12,35,335,9.6,1,2,-1,-0.5,0,37,334,9,1,quayvon-skanes-1
382,Kendal Keys,UNLV,MWC,11,27,260,9.6,3,0,0,,0,27,260,9.6,3,kendal-keys-1
383,Nacarius Fant,Western Kentucky,CUSA,13,74,704,9.5,4,1,-21,-21,0,75,683,9.1,4,nacarius-fant-1
384,Larry Rose III,New Mexico State,Sun Belt,12,55,522,9.5,2,186,934,5,10,241,1456,6,12,larry-rose-iii-1
385,Johnathan Lloyd,Duke,ACC,12,39,367,9.4,1,1,3,3,0,40,370,9.3,1,johnathan-lloyd-1
386,Richie James,Middle Tennessee State,CUSA,5,31,290,9.4,3,10,57,5.7,0,41,347,8.5,3,richie-james-1
387,Shane Wimann,Northern Illinois,MAC,11,30,283,9.4,7,0,0,,0,30,283,9.4,7,shane-wimann-1
388,Terry Wright,Purdue,Big Ten,10,29,274,9.4,0,5,45,9,0,34,319,9.4,0,terry-wright-2
389,Ronnie Turner Jr.,UAB,CUSA,9,28,262,9.4,1,0,0,,0,28,262,9.4,1,ronnie-turner-jr-1
390,Isaiah Johnson-Mack,Washington State,Pac-12,12,60,555,9.3,5,0,0,,0,60,555,9.3,5,isaiah-johnson-mack-1
391,Jason Huntley,New Mexico State,Sun Belt,12,39,363,9.3,2,71,435,6.1,1,110,798,7.3,3,jason-huntley-1
392,Michael Jacquet,Louisiana,Sun Belt,10,31,288,9.3,2,0,0,,0,31,288,9.3,2,michael-jacquet-1
393,Jordan Wilkins,Ole Miss,SEC,12,26,241,9.3,1,155,1011,6.5,9,181,1252,6.9,10,jordan-wilkins-1
394,Kyle Sweet,Washington State,Pac-12,13,58,533,9.2,2,0,0,,0,58,533,9.2,2,kyle-sweet-1
395,Tony Gaiter IV,Florida International,CUSA,12,34,314,9.2,1,0,0,,0,34,314,9.2,1,tony-gaiter-iv-1
396,Jaron Johnson,Eastern Michigan,MAC,12,23,212,9.2,1,0,0,,0,23,212,9.2,1,jaron-johnson-1
397,Ryan Yurachek,Marshall,CUSA,13,54,490,9.1,10,1,4,4,0,55,494,9,10,ryan-yurachek-1
398,Keishawn Watson,Western Michigan,MAC,10,41,374,9.1,7,1,4,4,0,42,378,9,7,keishawn-watson-1
399,Jamire Calvin,Washington State,Pac-12,13,33,300,9.1,3,0,0,,0,33,300,9.1,3,jamire-calvin-1
400,Eli Stove,Auburn,SEC,14,29,265,9.1,0,30,315,10.5,2,59,580,9.8,2,eli-stove-1
401,D'Eriq King,Houston,American,10,29,264,9.1,2,72,379,5.3,8,101,643,6.4,10,deriq-king-1
402,Ravian Pierce,Syracuse,ACC,10,29,263,9.1,4,0,0,,0,29,263,9.1,4,ravian-pierce-1
403,Austin Conway,Wyoming,MWC,13,61,549,9,3,15,70,4.7,1,76,619,8.1,4,austin-conway-1
404,Tra'Von Chapman,Akron,MAC,14,53,475,9,2,0,0,,0,53,475,9,2,travon-chapman-1
405,Jackson Anthrop,Purdue,Big Ten,13,47,423,9,5,10,17,1.7,2,57,440,7.7,7,jackson-anthrop-1
406,Armanti Foreman,Texas,Big 12,9,31,280,9,4,5,32,6.4,1,36,312,8.7,5,armanti-foreman-1
407,Isaiah Hodgins,Oregon State,Pac-12,11,31,275,8.9,2,0,0,,0,31,275,8.9,2,isaiah-hodgins-1
408,Tyraiq Beals,Connecticut,American,11,30,266,8.9,0,2,4,2,0,32,270,8.4,0,tyraiq-beals-1
409,Kenny Young,Miami (OH),MAC,11,29,259,8.9,2,143,781,5.5,6,172,1040,6,8,kenny-young-2
410,Ryan Nall,Oregon State,Pac-12,11,27,240,8.9,2,165,810,4.9,8,192,1050,5.5,10,ryan-nail-1
411,Jaelon Darden,North Texas,CUSA,13,32,281,8.8,3,1,1,1,0,33,282,8.5,3,jaelon-darden-1
412,Chase Harrell,Kansas,Big 12,10,25,221,8.8,3,0,0,,0,25,221,8.8,3,chase-harrell-1
413,Deondre Farrier,East Carolina,American,7,24,211,8.8,3,2,20,10,0,26,231,8.9,3,deondre-farrier-1
414,Luke Timian,Indiana,Big Ten,12,68,589,8.7,2,1,7,7,0,69,596,8.6,2,luke-timian-1
415,D.J. Brown,Northern Illinois,MAC,13,42,365,8.7,3,22,108,4.9,1,64,473,7.4,4,dj-brown-3
416,Justin Stockton,Texas Tech,Big 12,11,27,235,8.7,1,132,797,6,4,159,1032,6.5,5,justin-stockton-1
417,Bryce Wolma,Arizona,Pac-12,10,28,241,8.6,2,0,0,,0,28,241,8.6,2,bryce-wolma-1
418,Josh Oliver,San Jose State,MWC,10,35,296,8.5,1,0,0,,0,35,296,8.5,1,josh-oliver-1
419,Jamal Morrow,Washington State,Pac-12,13,60,506,8.4,5,86,522,6.1,4,146,1028,7,9,jamal-morrow-1
420,Tony Nicholson,Baylor,Big 12,11,41,344,8.4,0,4,41,10.3,0,45,385,8.6,0,tony-nicholson-1
421,Conner Cramer,New Mexico State,Sun Belt,11,33,277,8.4,2,0,0,,0,33,277,8.4,2,conner-cramer-1
422,Zack Moss,Utah,Pac-12,13,29,243,8.4,0,214,1173,5.5,10,243,1416,5.8,10,zack-moss-1
423,Andrew Celis,Nevada,MWC,8,23,194,8.4,0,1,2,2,0,24,196,8.2,0,andrew-celis-1
424,Qadree Ollison,Pitt,ACC,12,23,194,8.4,2,90,398,4.4,5,113,592,5.2,7,oadree-ollison-1
425,Cameron Batson,Texas Tech,Big 12,13,59,487,8.3,5,6,38,6.3,0,65,525,8.1,5,cameron-batson-1
426,Tyler Watts,Texas State,Sun Belt,10,40,332,8.3,2,5,138,27.6,1,45,470,10.4,3,tyler-watts-2
427,Evan Butts,Virginia,ACC,11,32,266,8.3,2,0,0,,0,32,266,8.3,2,evan-butts-1
428,David Montgomery,Iowa State,Big 12,13,36,296,8.2,0,258,1146,4.4,11,294,1442,4.9,11,david-montgomery-1
429,Jordon Brown,North Carolina,ACC,12,29,237,8.2,0,138,613,4.4,4,167,850,5.1,4,jordon-brown-1
430,John Kelly,Tennessee,SEC,11,37,299,8.1,0,189,778,4.1,9,226,1077,4.8,9,john-kelly-6
431,Glenn Smith,Georgia State,Sun Belt,12,47,377,8,1,170,594,3.5,3,217,971,4.5,4,glenn-smith-2
432,Marquis Young,Massachusetts,Ind,12,35,280,8,2,182,982,5.4,9,217,1262,5.8,11,marquis-young-1
433,Jaylen Samuels,North Carolina State,ACC,13,75,593,7.9,4,78,407,5.2,12,153,1000,6.5,16,jaylen-samuels-1
434,Connor Wedington,Stanford,Pac-12,13,31,243,7.8,0,3,57,19,0,34,300,8.8,0,connor-wedington-1
435,Marcus Armstrong-Brown,Hawaii,MWC,9,24,184,7.7,1,0,0,,0,24,184,7.7,1,marcus-armstrong-brown-1
436,Justin Rankin,Kent State,MAC,12,42,311,7.4,2,123,490,4,3,165,801,4.9,5,justin-rankin-1
437,Mike Boone,Cincinnati,American,10,24,177,7.4,1,110,463,4.2,4,134,640,4.8,5,mike-boone-2
438,Shaun Wilson,Duke,ACC,13,36,263,7.3,4,162,818,5,6,198,1081,5.5,10,shaun-wilson-1
439,Hussein Howe,East Carolina,American,12,30,219,7.3,0,96,419,4.4,3,126,638,5.1,3,hussein-howe-1
440,Jordan Chunn,Troy,Sun Belt,10,28,204,7.3,0,154,774,5,10,182,978,5.4,10,jordan-chunn-1
441,Troy McCormick,Utah,Pac-12,11,25,183,7.3,2,10,60,6,0,35,243,6.9,2,troy-mccormick-1
442,Patrick Laird,California,Pac-12,11,45,322,7.2,1,191,1127,5.9,8,236,1449,6.1,9,patrick-laird-2
443,Brandon Fritts,North Carolina,ACC,9,25,177,7.1,4,0,0,,0,25,177,7.1,4,brandon-fritts-1
444,David Hood,Temple,American,13,25,172,6.9,1,130,638,4.9,5,155,810,5.2,6,david-hood-2
445,James Williams,Washington State,Pac-12,13,71,482,6.8,3,92,395,4.3,1,163,877,5.4,4,james-williams-13
446,Adrian Killins,UCF,American,13,25,169,6.8,1,123,790,6.4,10,148,959,6.5,11,adrian-killins-1
447,Tyler Cogswell,Cincinnati,American,11,23,149,6.5,2,0,0,,0,23,149,6.5,2,tyler-cogswell-1
448,Nolan Givan,Ball State,MAC,11,25,159,6.4,4,0,0,,0,25,159,6.4,4,nolan-givan-1
449,Justin Jackson,Northwestern,Big Ten,13,44,276,6.3,0,287,1311,4.6,11,331,1587,4.8,11,justin-jackson-5
450,Lajuan Hunt,Utah State,MWC,13,30,187,6.2,1,169,828,4.9,11,199,1015,5.1,12,lajuan-hunt-1
451,Justice Hill,Oklahoma State,Big 12,13,31,190,6.1,1,268,1467,5.5,15,299,1657,5.5,16,justice-hill-1
452,Nyheim Hines,North Carolina State,ACC,13,26,152,5.8,0,197,1113,5.6,12,223,1265,5.7,12,nyheim-hines-1
453,Diocemy Saint Juste,Hawaii,MWC,12,28,157,5.6,1,282,1510,5.4,7,310,1667,5.4,8,diocemy-saint-juste-1
454,John Leday,Houston,American,11,25,141,5.6,1,1,3,3,0,26,144,5.5,1,john-leday-1
455,JaMycal Hasty,Baylor,Big 12,8,25,105,4.2,0,76,314,4.1,1,101,419,4.1,1,jamycal-hasty-1